UNITID,INSTNM,CONTROL,inst_spend,rsch_spend,serv_spend,total_spend,inst_prop,rsch_prop,serv_prop
100654,Alabama A & M University,1,32957353,12837888,20578573,66373814,0.49654149752491245,0.19341796450027718,0.31004053797481035
100663,University of Alabama at Birmingham,1,297179571,309254195,44287689,650721455,0.4566924430054331,0.47524819202403584,0.06805936497053106
100706,University of Alabama in Huntsville,1,71302241,83802490,21213673,176318404,0.40439477321947626,0.47529065655562536,0.12031457022489836
100724,Alabama State University,1,39655073,3527160,16109713,59291946,0.6688104485556943,0.05948801208177583,0.27170153936252994
100751,The University of Alabama,1,361807147,85757568,66981218,514545933,0.7031581124167587,0.16666649661382127,0.13017539096942002
100830,Auburn University at Montgomery,1,30454417,444565,7786835,38685817,0.7872243463282681,0.011491679237380458,0.20128397443435148
100858,Auburn University,1,252146479,208187924,40706539,501040942,0.5032452597456597,0.41551080270801505,0.0812439375463253
101453,Heritage Christian University,2,598113,14435,396591,1009139,0.5926963480749431,0.014304273246797517,0.3929993786782594
101480,Jacksonville State University,1,47659611,2408127,21295563,71363301,0.6678448212478287,0.03374461335525945,0.2984105653969118
101587,University of West Alabama,1,32151487,673543,11164796,43989826,0.7308846140923585,0.01531133585297655,0.2538040500546649
101709,University of Montevallo,1,28583870,38609,13163709,41786188,0.684050672437505,9.239655936071507e-4,0.3150253619688879
101879,University of North Alabama,1,45374378,83292,11598392,57056062,0.7952595466543064,0.001459827353664892,0.20328062599202867
101912,Oakwood University,2,11789090,723744,5089194,17602028,0.6697574847625513,0.04111708037278432,0.28912543486466447
102094,University of South Alabama,1,139221000,35455000,48454000,223130000,0.6239456818894815,0.15889840003585354,0.217155918074665
102368,Troy University,1,91128180,783240,43085522,134996942,0.6750388464354993,0.005801909201765474,0.3191592443627353
102377,Tuskegee University,2,39257313,25245462,9783026,74285801,0.5284632119669814,0.33984236099170556,0.13169442704131304
102395,United States Sports Academy,2,1329717,149694,825936,2305347,0.5767968986881368,0.06493339180609253,0.3582697095057707
102553,University of Alaska Anchorage,1,127133324,22188287,33009573,182331184,0.6972659377893361,0.12169222243409553,0.18104183977656835
102614,University of Alaska Fairbanks,1,92872585,150246915,25862551,268982051,0.34527428374765423,0.5585759884030329,0.09614972784931289
102632,University of Alaska Southeast,1,22386484,1280514,4852136,28519134,0.7849636668490705,0.04490017123240839,0.1701361619185211
102669,Alaska Pacific University,2,5089743,1816599,3658560,10564902,0.48175960363853826,0.1719466020602936,0.34629379430116813
104151,Arizona State University-Tempe,1,1076790000,361046000,169169000,1607005000,0.6700601429367052,0.22467011614774068,0.10526974091555409
104179,University of Arizona,1,592335000,528754000,96276000,1217365000,0.48657140627502843,0.43434302776899286,0.0790855659559787
104586,Embry-Riddle Aeronautical University-Prescott,2,37340000,1473000,13038000,51851000,0.7201404023066094,0.028408323851034697,0.251451273842356
105297,Dine College,1,9372801,1565692,1628001,12566494,0.7458564815293749,0.12459258724032335,0.12955093123030179
105330,Northern Arizona University,1,210643111,55242435,66681867,332567413,0.6333846996608775,0.16610898374459798,0.20050631659452456
106245,University of Arkansas at Little Rock,1,61672729,14308237,9768795,85749761,0.7192175031251691,0.16686037177409743,0.11392212510073352
106263,University of Arkansas for Medical Sciences,1,127129000,144024000,4090000,275243000,0.46187913952398424,0.5232612636833635,0.014859596792652311
106397,University of Arkansas,1,280937314,169365622,47071943,497374879,0.5648401756132923,0.3405190514255948,0.0946407729611129
106412,University of Arkansas at Pine Bluff,1,18448558,8678604,6147208,33274370,0.5544374844662724,0.2608194835845126,0.18474303194921496
106458,Arkansas State University-Main Campus,1,65784700,10741436,12420139,88946275,0.7396003936083889,0.1207631910386354,0.13963641535297572
106467,Arkansas Tech University,1,45262767,4910898,8175009,58348674,0.77572914510448,0.08416468898676258,0.1401061659087574
106485,University of Arkansas at Monticello,1,21307255,81147,3705470,25093872,0.8491019241669838,0.0032337377029738575,0.14766433813004226
106704,University of Central Arkansas,1,84021531,4272587,9544771,97838889,0.8587743775381587,0.043669618938538844,0.09755600352330247
107071,Henderson State University,1,20582629,199304,7207492,27989425,0.7353716269626832,0.007120689331774411,0.25750768370554233
107080,Hendrix College,2,18060066,1295237,10558338,29913641,0.6037401465104164,0.043299209213615956,0.35296064427596763
107141,John Brown University,2,18996346,137716,9568739,28702801,0.6618289971072858,0.0047979986343493096,0.3333730042583649
107512,Ouachita Baptist University,2,14893299,300560,9368312,24562171,0.6063510835422488,0.012236703343527736,0.3814122131142235
107983,Southern Arkansas University Main Campus,1,24375515,413846,7028642,31818003,0.7660919197223032,0.01300666166886715,0.22090141860882972
108092,University of Arkansas-Fort Smith,1,33670114,17073,7336714,41023901,0.8207438390610391,4.161720261561669e-4,0.17883998891280475
108807,Allan Hancock College,1,46876814,757023,17361663,64995500,0.7212316852705187,0.011647314044818488,0.26712100068466277
109350,Antelope Valley College,1,48115318,1424589,19562219,69102126,0.6962928752727521,0.02061570435618725,0.28309142037106066
109785,Azusa Pacific University,2,101777507,5128382,47571879,154477768,0.6588488966256943,0.033198188104323206,0.3079529152699824
109907,Barstow Community College,1,8880360,241606,5093396,14215362,0.6247016431941727,0.01699612011287507,0.3583022366929523
110060,Bethesda University,2,321776,109,144361,466246,0.6901421138197432,2.3378216649579836e-4,0.309624104013761
110097,Biola University,2,61222000,1945000,23156000,86323000,0.7092200224737324,0.022531654367897315,0.2682483231583703
110404,California Institute of Technology,2,235824596,257982335,25914081,519721012,0.45375228354246333,0.4963861938297003,0.04986152262783634
110422,California Polytechnic State University-San Luis Obispo,1,219559005,2847727,78536402,300943134,0.7295697432326201,0.009462674765658551,0.2609675820017213
110468,Alliant International University-San Diego,3,25685858,76869,14378055,40140782,0.6398943099813053,0.0019149851141415232,0.3581907049045532
110486,California State University-Bakersfield,1,62965311,1852260,24014510,88832081,0.7088127429999079,0.02085125079980959,0.27033600620028253
110495,California State University-Stanislaus,1,77166045,1046142,20788463,99000650,0.779449882399762,0.010567021529656623,0.20998309607058135
110510,California State University-San Bernardino,1,124842647,1041988,35385371,161270006,0.7741219219648321,0.006461139463217977,0.21941693857194994
110529,California State Polytechnic University-Pomona,1,168263765,2186714,40887945,211338424,0.7961816020734592,0.010346977887939583,0.1934714200386012
110538,California State University-Chico,1,115712509,1496995,33309600,150519104,0.7687562968751129,0.009945548174403164,0.22129815495048388
110547,California State University-Dominguez Hills,1,93211781,1235446,27427336,121874563,0.764817355693821,0.010137029168260484,0.2250456151379185
110556,California State University-Fresno,1,160513843,5168970,60998418,226681231,0.7081038085592538,0.022802814230349754,0.2690933772103964
110565,California State University-Fullerton,1,245103700,1181531,51659463,297944694,0.8226483133812748,0.003965605106563837,0.17338608151216145
110574,California State University-East Bay,1,86908850,1850324,34136930,122896104,0.707173353518188,0.01505600210076635,0.27777064438104565
110583,California State University-Long Beach,1,254441977,2970220,65843490,323255687,0.7871229717916765,0.009188453968328793,0.20368857423999473
110592,California State University-Los Angeles,1,163771404,203098,31528944,195503446,0.8376906256680509,0.0010388461388041211,0.161270528193145
110608,California State University-Northridge,1,231047819,4639584,98005757,333693160,0.6923960293342543,0.013903743187304168,0.29370022747844154
110617,California State University-Sacramento,1,206763173,2098718,57499767,266361658,0.7762497596407062,0.007879204596331204,0.21587103576296254
110635,University of California-Berkeley,1,853739757,662825751,253749677,1770315185,0.48225297067651823,0.37441115379688733,0.14333587552659444
110644,University of California-Davis,1,884808691,634574456,156069370,1675452517,0.5281013230887044,0.37874809913219404,0.09315057777910157
110653,University of California-Irvine,1,783267762,338664617,127228576,1249160955,0.6270350981311291,0.27111367485865745,0.10185122701021343
110662,University of California-Los Angeles,1,2504008515,926464931,202502300,3632975746,0.6892444899355515,0.25501544622753447,0.055740063836913926
110671,University of California-Riverside,1,377629373,155862036,106566964,640058373,0.5899920834251785,0.24351222103300257,0.16649569554181898
110680,University of California-San Diego,1,809309567,911718774,150522491,1871550832,0.4324272433119786,0.4871461455448195,0.0804266111432019
110699,University of California-San Francisco,1,360754082,1149397917,35230175,1545382174,0.23344004355002998,0.7437628933074518,0.02279706314251817
110705,University of California-Santa Barbara,1,378328684,212371726,111823431,702523841,0.5385278931765107,0.30229824755513174,0.15917385926835756
110714,University of California-Santa Cruz,1,207302849,124678550,99178784,431160183,0.4808023958928508,0.28916990695311956,0.23002769715402965
111188,California State University Maritime Academy,1,22118965,4241960,8773092,35134017,0.6295598080914004,0.12073654999369984,0.24970364191489974
111887,Cerritos College,1,101389590,769166,24205643,126364399,0.8023588194329955,0.006086888443951686,0.19155429212305278
111948,Chapman University,2,157427328,13142303,31881815,202451446,0.7776053523470512,0.06491582678051111,0.15747882087243772
111966,Charles R Drew University of Medicine and Science,2,16248800,15723000,1834600,33806400,0.4806427185385016,0.4650894505182451,0.054267830943253346
112251,Claremont Graduate University,2,32626881,9040257,5427213,47094351,0.6927981871965918,0.19196053896145635,0.11524127384195187
112260,Claremont McKenna College,2,42011000,9826000,23033000,74870000,0.5611192734072392,0.1312408174168559,0.3076399091759049
112525,Western University of Health Sciences,2,121396275,17041630,8890938,147328843,0.8239817304477168,0.11567069728498444,0.06034757226729867
113193,Cuesta College,1,36403075,370582,13508607,50282264,0.7239744614522529,0.007370034093930218,0.268655504453817
113582,Design Institute of San Diego,3,712691,12000,552858,1277549,0.5578580547595434,0.009392986100728817,0.4327489591397277
113704,Dominican School of Philosophy & Theology,2,907335,12587,391634,1311556,0.6918004263637999,0.009596997764487372,0.2986025758717127
114549,Fielding Graduate University,2,10514777,851819,2714314,14080910,0.7467398768971608,0.06049459871556597,0.19276552438727326
114840,Fuller Theological Seminary,2,20005000,1952000,6768000,28725000,0.696431679721497,0.06795474325500435,0.2356135770234987
114938,Gavilan College,1,17924189,442694,9340401,27707284,0.6469125230751596,0.015977531395715294,0.3371099455291251
115001,Glendale Community College,1,75287563,648000,24969901,100905464,0.7461197839593702,0.006421852438040422,0.24745836360258944
115409,Harvey Mudd College,2,30426186,4025138,7860600,42311924,0.7190924714272033,0.09513011036794261,0.18577741820485402
115746,Pacifica Graduate Institute,3,7147176,27953,1338985,8514114,0.83945035267322,0.0032831366833941853,0.1572665106433858
115755,Humboldt State University,1,65523833,407421,25645257,91576511,0.7155091658820677,0.004448968360456536,0.28004186575747575
115861,Imperial Valley College,1,32961153,269588,20566766,53797507,0.6126892274023032,0.005011161576687931,0.38229961102100884
117195,Lake Tahoe Community College,1,8198932,425569,2917036,11541537,0.7103847607125463,0.03687281858560086,0.2527424207018528
117520,Life Chiropractic College West,2,8211526,379507,4080303,12671336,0.6480394806040973,0.029950038417417075,0.3220104809784856
117627,La Sierra University,2,17278457,88649,8559847,25926953,0.6664283689641433,0.003419183118047076,0.3301524479178097
117636,Loma Linda University,2,153372000,18809000,5500000,177681000,0.8631873976395901,0.10585825158570697,0.030954350774702977
117645,Long Beach City College,1,76134459,1680694,24073430,101888583,0.7472324843304573,0.016495410481859384,0.2362721051876833
117672,Southern California University of Health Sciences,2,13011183,410869,2557853,15979905,0.8142215488765421,0.02571160466848833,0.16006684645496955
117946,Loyola Marymount University,2,157999000,6258000,66026000,230283000,0.6861079628109761,0.027175258269173146,0.2867167789198508
118888,Mills College,2,17325750,1587579,9787426,28700755,0.6036687885039957,0.05531488631570842,0.3410163251802958
119216,Mt San Jacinto Community College District,1,46565576,305818,15293012,62164406,0.7490713576511935,0.00491950329260767,0.2460091390561988
119605,National University,2,77328111,2095181,34929099,114352391,0.676226446371375,0.018322144221715485,0.30545140940690957
120254,Occidental College,2,43655920,4009678,16119215,63784813,0.684424990005066,0.06286258141103275,0.2527124285839013
120290,Ohlone College,1,30966425,261957,10115368,41343750,0.7489989417989418,0.006336072562358277,0.24466498563869993
120883,University of the Pacific,2,162697729,14829969,41956839,219484537,0.7412719420867449,0.06756726101392738,0.1911607968993278
120953,Palo Verde College,1,7622295,156602,4153179,11932076,0.6388071111850109,0.013124455459385273,0.34806843335560383
120971,Palomar College,1,96900657,839881,32781837,130522375,0.7424064801149994,0.00643476645287829,0.2511587534321223
121150,Pepperdine University,2,104072000,3082000,66547000,173701000,0.5991445069400867,0.017743133315294674,0.3831123597446186
121257,Pitzer College,2,25552898,467703,17950744,43971345,0.5811261402169982,0.010636540683483756,0.4082373190995181
121309,Point Loma Nazarene University,2,36360707,525703,27661030,64547440,0.5633175692173075,0.00814444383851629,0.4285379869441763
121345,Pomona College,2,67676000,2728000,23392000,93796000,0.7215233058979061,0.02908439592306708,0.24939229817902683
121628,Pardee RAND Graduate School,2,761163,524771,763201,2049135,0.3714557606014245,0.25609391279735105,0.3724503266012244
122117,Dongguk University-Los Angeles,2,486000,52309,210859,749168,0.6487196463276594,0.06982279008179741,0.28145756359054314
122409,San Diego State University,1,249046808,6445403,105457763,360949974,0.6899759688028125,0.017856776462879035,0.29216725473430843
122436,University of San Diego,2,140904000,4395000,44130000,189429000,0.7438354211868299,0.023201304974423135,0.23296327383874696
122597,San Francisco State University,1,213751945,21100416,48046499,282898860,0.7555772582469933,0.07458642993471236,0.16983631181829437
122612,University of San Francisco,2,180048000,2864000,53808000,236720000,0.7605947955390334,0.012098681987157824,0.22730652247380873
122728,William Jessup University,2,11101552,10000,7847331,18958883,0.5855593918692362,5.274572346904615e-4,0.41391315089607333
122755,San Jose State University,1,243913932,947241,78668789,323529962,0.7539145076152174,0.0029278308387400607,0.24315766154604251
122931,Santa Clara University,2,156072000,6049000,67400000,229521000,0.679990066268446,0.026354886916665578,0.2936550468148884
123165,Scripps College,2,28315147,75862,16758802,45149811,0.6271376639871206,0.0016802285174571383,0.3711821074954223
123280,Shasta Bible College and Graduate School,2,161991,105011,14591,281593,0.5752664306286023,0.3729176506518273,0.05181591871957044
123484,College of the Siskiyous,1,13246786,124899,4433728,17805413,0.7439752169747481,0.007014664585426915,0.249010118439825
123572,Sonoma State University,1,68541988,1729466,27019550,97291004,0.7045048892701323,0.01777621700768963,0.27771889372217806
123633,South Baylo University,2,1226924,82154,306995,1616073,0.7592008529317673,0.050835574878115034,0.18996357219011764
123800,Southwestern College,1,61919637,300515,23722000,85942152,0.7204804110560322,0.003496712532867457,0.27602287641110035
123943,Marshall B Ketchum University,2,30476685,742231,1608145,32827061,0.9284012662601748,0.02261033968286104,0.04898839405696416
123961,University of Southern California,2,2368261114,460820000,295378000,3124459114,0.7579747494177004,0.14748792772968897,0.09453732285261071
124113,Taft College,1,15277845,302189,7277255,22857289,0.66840144515826,0.013220684220250268,0.3183778706214897
124283,Claremont School of Theology,2,3360469,430935,1153240,4944644,0.679617986653842,0.08715187584788713,0.23323013749827085
124557,University of California-System Administration Central Office,1,299788853,210120270,32143915,542053038,0.5530618444758167,0.3876378421847347,0.059300313339448525
125091,Victor Valley College,1,44989842,555476,18466565,64011883,0.7028357844120912,0.00867770129492988,0.288486514292979
125727,Westmont College,2,24225394,444542,10613820,35283756,0.6865877317596233,0.012599055497379587,0.3008132127429971
125763,Whittier College,2,25445684,914813,14892572,41253069,0.6168191753200228,0.022175634981242243,0.3610051896987349
126012,The Wright Institute,2,8161305,29770,1689035,9880110,0.8260338194615242,0.0030131243478058443,0.17095305619066994
126049,Thomas Jefferson School of Law,2,3126028,1042009,1607900,5775937,0.5412157369444992,0.18040518793747232,0.27837907511802845
126562,University of Colorado Denver/Anschutz Medical Campus,1,584952717,358754095,31031816,974738628,0.6001123790489608,0.36805158295214296,0.031836037998896255
126580,University of Colorado Colorado Springs,1,92106637,5221007,21302710,118630354,0.7764171132794563,0.04401071752681443,0.1795721691937293
126614,University of Colorado Boulder,1,607748280,434258834,67775271,1109782385,0.5476283352614215,0.39130088913782857,0.061070775600749874
126678,Colorado College,2,66727786,1199793,30258301,98185880,0.6796067418247919,0.01221960835916529,0.3081736498160428
126775,Colorado School of Mines,1,103595137,68228001,11220040,183043178,0.5659601091497658,0.37274265965814907,0.06129723119208518
126818,Colorado State University-Fort Collins,1,378889528,259368441,39884927,678142896,0.5587163564417845,0.38246871349663153,0.058814930061583955
127060,University of Denver,2,180310037,17283965,65028017,262622019,0.6865762348738931,0.06581308401257854,0.2476106811135284
127185,Fort Lewis College,1,23625889,1271847,9993284,34891020,0.6771338011901057,0.036451986786284835,0.2864142120236095
127556,Colorado Mesa University,1,62769623,378102,18505502,81653227,0.7687341371088738,0.00463058245083198,0.22663528044029418
127565,Metropolitan State University of Denver,1,97819281,647378,25619991,124086650,0.7883143029487862,0.00521714463240002,0.2064685524188138
127741,University of Northern Colorado,1,101303782,4483328,37245548,143032658,0.7082563060528456,0.03134478560833289,0.26039890833882146
128106,Colorado State University-Pueblo,1,30826084,4457676,6883787,42167547,0.7310381132675325,0.10571342933464922,0.1632484573978183
128328,United States Air Force Academy,1,143200051,4137847,28994335,176332233,0.8121036554899183,0.02346619747054414,0.16443014703953757
128391,Western State Colorado University,1,24367809,517231,7461750,32346790,0.7533300522246567,0.015990180169346016,0.23067976760599737
128744,University of Bridgeport,2,44765000,200000,15196000,60161000,0.7440867006864913,0.003324412825584681,0.25258888648792405
128771,Central Connecticut State University,1,127393657,2195659,34975412,164564728,0.7741249206209,0.013342221183630553,0.21253285819546944
128902,Connecticut College,2,36336000,1219000,15584000,53139000,0.683791565516852,0.02293983703118237,0.2932685974519656
129020,University of Connecticut,1,601754152,181631401,47887699,831273252,0.7238945203063024,0.21849782915906935,0.057607650534628296
129215,Eastern Connecticut State University,1,58134810,2253147,18626514,79014471,0.7357488984517785,0.028515624688545977,0.2357354768596755
129242,Fairfield University,2,74087149,1308923,32227321,107623393,0.6883926155348029,0.012162067776473095,0.299445316688724
129482,American Institute-West Hartford,3,2082989,130187,1399033,3612209,0.5766524030032593,0.03604082709499921,0.38730676990174157
129491,Hartford Seminary,2,1495180,227792,12972,1735944,0.8613065859267349,0.13122082279151862,0.007472591281746416
129525,University of Hartford,2,89331000,3051000,22398000,114780000,0.7782801881860951,0.02658128593831678,0.19513852587558808
129941,University of New Haven,2,64562353,5448185,29821689,99832227,0.6467085323059056,0.05457340944623022,0.2987180582478642
130226,Quinnipiac University,2,168773623,1519674,60513058,230806355,0.7312347313833711,0.006584194789610537,0.26218107382701833
130493,Southern Connecticut State University,1,115914468,2565867,31851023,150331358,0.7710598077614652,0.017068075710458225,0.2118721165280766
130590,Trinity College,2,64374530,2052581,29262497,95689608,0.6727431676802355,0.021450406610506755,0.3058064257092578
130697,Wesleyan University,2,98424000,10216000,18411000,127051000,0.7746810336006801,0.08040865479217008,0.14491031160714987
130776,Western Connecticut State University,1,67830655,1239009,21926424,90996088,0.7454238582212457,0.013616068857817272,0.240960072920937
130794,Yale University,2,939350388,574753966,377321254,1891425608,0.4966361796239358,0.30387341884820246,0.19949040152786174
130934,Delaware State University,1,50816107,16169906,18907887,85893900,0.5916148527427443,0.1882544162041775,0.2201307310530783
130943,University of Delaware,1,489597089,156712031,43779630,690088750,0.7094697442901367,0.22708967650899975,0.06344057920086366
131159,American University,2,216894000,66475000,55979000,339348000,0.6391491919799144,0.19589035444440514,0.16496045357568043
131283,Catholic University of America,2,103914585,19150091,31420641,154485317,0.6726502363975471,0.12396058973034958,0.20338917387210334
131399,University of the District of Columbia,1,39488665,5051219,15367845,59907729,0.6591581029552964,0.08431664969306381,0.25652524735163973
131405,Pontifical Faculty of the Immaculate Conception at the Dominican House of Studies,2,2323700,6289,70042,2400031,0.9681958274705619,0.002620382820055241,0.029183789709382922
131450,Gallaudet University,2,55962511,7497263,12391507,75851281,0.7377925627913917,0.09884161349892034,0.1633658237096879
131469,George Washington University,2,558209000,210673000,107351000,876233000,0.6370554407332296,0.2404303421578507,0.12251421710891966
131496,Georgetown University,2,525441000,235133000,137261000,897835000,0.5852311393518854,0.2618888771322125,0.15287998351590215
131520,Howard University,2,218158000,42925000,34090000,295173000,0.7390852144335694,0.1454231925006691,0.11549159306576144
132602,Bethune-Cookman University,2,26754959,1096731,7624751,35476441,0.7541613038354101,0.030914346791438296,0.2149243493731516
132842,Carlos Albizu University-Miami,2,3637605,109609,1026252,4773466,0.7620469067968642,0.022962141136021498,0.21499095206711433
132903,University of Central Florida,1,439258038,177160186,63670981,680089205,0.6458829735431545,0.26049551249677605,0.0936215139600694
133492,Eckerd College,2,31401881,381292,14646016,46429189,0.6763392098018339,0.008212333840248642,0.3154484563579174
133553,Embry-Riddle Aeronautical University-Daytona Beach,2,94918000,12588000,27136000,134642000,0.7049657610552428,0.09349237236523522,0.201541866579522
133650,Florida Agricultural and Mechanical University,1,81108275,29920118,11426895,122455288,0.6623501224381588,0.24433504251772287,0.0933148350441183
133669,Florida Atlantic University,1,216429987,70590655,25580508,312601150,0.6923518579506186,0.2258170035522902,0.08183113849709125
133872,AdventHealth University,2,16260365,27136,689253,16976754,0.9578017682296628,0.0015984209937895076,0.04059981077654774
133881,Florida Institute of Technology,2,66657938,15791814,19523829,101973581,0.6536785052198961,0.15486181661110832,0.19145967816899556
133951,Florida International University,1,332936920,160690983,84975099,578603002,0.5754151272101419,0.2777223457959176,0.14686252699394048
134097,Florida State University,1,453640983,200161932,63086819,716889734,0.632790457841875,0.279208813443547,0.08800072871457802
134130,University of Florida,1,816823000,760304000,49231000,1626358000,0.5022405890953898,0.467488707898261,0.030270703006349157
134945,Jacksonville University,2,42214476,1495265,23962082,67671823,0.6238117155496166,0.022095828569595355,0.3540924558807881
135081,Keiser University-Ft Lauderdale,2,140097152,429156,157540400,298066708,0.4700194561816008,0.0014397985030921332,0.528540745315307
135726,University of Miami,2,509598246,275382894,65775228,850756368,0.5989943362962874,0.3236918398241128,0.0773138238795998
136172,University of North Florida,1,97656015,6300280,22711222,126667517,0.7709633638748915,0.049738718727706646,0.1792979173974019
136215,Nova Southeastern University,2,304135113,20448735,45444541,370028389,0.8219237281277897,0.055262611215487034,0.12281366065672329
136330,Palm Beach Atlantic University,2,33780473,72527,12891000,46744000,0.7226697116207428,0.0015515788122539792,0.27577870956700323
137351,University of South Florida-Main Campus,1,389791070,344496945,52642040,786930055,0.4953312782036264,0.43777327198412824,0.06689544981224538
137546,Stetson University,2,57541310,946765,28761619,87249694,0.6595015679940379,0.010851212842075984,0.3296472191638861
137777,Talmudic College of Florida,2,1442726,105000,375000,1922726,0.7503544446790651,0.054609965226454525,0.19503559009448043
137847,The University of Tampa,2,66457780,450607,26896303,93804690,0.7084696937860996,0.004803672396337539,0.28672663381756286
137865,Tom P Haney Technical Center,1,1525415,54952,466489,2046856,0.7452478337508843,0.026847027831953005,0.2279051384171627
138354,The University of West Florida,1,65567765,19365011,13733849,98666625,0.6645384394165706,0.19626708626143846,0.13919447432199084
138716,Albany State University,1,31120896,1238666,6033696,38393258,0.8105823163014715,0.032262591520625834,0.1571550921779027
138938,Atlanta School of Massage,3,866503,4177,344036,1214716,0.7133379324879231,0.0034386638522914,0.2832234036597855
138947,Clark Atlanta University,2,31031912,8149710,10680860,49862482,0.6223499263434179,0.16344372909475305,0.21420634456182908
139144,Berry College,2,30559388,408010,19345069,50312467,0.6073919611216838,0.00810952084699007,0.3844985180313261
139311,Clayton  State University,1,33893428,230728,10091552,44215708,0.7665472189204796,0.005218236016937691,0.22823454506258273
139366,Columbus State University,1,55947321,371581,10210796,66529698,0.8409375464172406,0.00558518994028802,0.15347726364247136
139658,Emory University,2,705434000,553777000,95014000,1354225000,0.5209134375749968,0.4089254001366095,0.07016116228839372
139719,Fort Valley State University,1,13214417,6949256,4330856,24494529,0.5394844293597154,0.28370645542929196,0.17680911521099263
139755,Georgia Institute of Technology-Main Campus,1,377181758,939843552,57103197,1374128507,0.2744879798931353,0.6839560835921149,0.041555936514749856
139764,Georgia Southwestern State University,1,17958500,31508,4012461,22002469,0.8162038542129068,0.0014320211063585636,0.1823641246807347
139861,Georgia College & State University,1,45921792,571991,11096210,57589993,0.7973918663264987,0.00993212483981375,0.1926760088336875
139931,Georgia Southern University,1,162152137,13913828,38538978,214604943,0.755584352966185,0.06483461100893655,0.17958103602487852
139940,Georgia State University,1,248006035,195225515,52148587,495380137,0.5006378263406229,0.39409233519591036,0.1052698384634667
139959,University of Georgia,1,396821007,460871801,47350950,905043758,0.43845505092141634,0.5092259870599538,0.052318962018629823
139968,Gordon State College,1,13282600,8577,2811360,16102537,0.8248762291308506,5.326489856846781e-4,0.1745911218834647
140252,Life University,2,17117109,593784,9187615,26898508,0.636359050100474,0.022074979028576604,0.3415659708709494
140447,Mercer University,2,104388610,41245753,26998753,172633116,0.6046847349960364,0.23892144193238105,0.15639382307158262
140553,Morehouse College,2,26917247,4622060,9725755,41265062,0.6523011403690608,0.1120090404807825,0.2356898191501566
140562,Morehouse School of Medicine,2,69688474,25853530,4192757,99734761,0.6987380658585024,0.2592228601219589,0.042039074019538686
140960,Savannah State University,1,22597375,1278443,5656608,29532426,0.7651716455668085,0.04328946765159083,0.19153888678160066
141060,Spelman College,2,33233814,4256126,12861164,50351104,0.6600414163709301,0.08452895094415408,0.2554296326849159
141264,Valdosta State University,1,66226539,236695,21817579,88280813,0.75018043841531,0.0026811601746350023,0.24713840141005497
141334,University of West Georgia,1,87846361,2209314,19666670,109722345,0.8006241663901733,0.02013549746863321,0.17924033614119347
141565,University of Hawaii at Hilo,1,52018343,9063338,10901254,71982935,0.7226482637864099,0.12590953675339855,0.1514421994601915
141574,University of Hawaii at Manoa,1,382502112,253635374,41776600,677914086,0.5642339050025286,0.37414088191700445,0.06162521308046696
141644,Hawaii Pacific University,2,22326493,4715288,15666672,42708453,0.5227652006032623,0.11040643406119159,0.3668283653355461
141796,Kapiolani Community College,1,48073368,124092,6664167,54861627,0.8762658096158905,0.002261908856622134,0.12147228152748733
141811,Leeward Community College,1,32855900,59020,5491532,38406452,0.8554786575963851,0.0015367209655294375,0.14298462143808546
141839,University of Hawaii Maui College,1,32730420,714340,3869475,37314235,0.8771563988917366,0.019143900444428246,0.10369970066383513
141963,University of Hawaii System Office,1,5376698,28862368,3680425,37919491,0.14179246235135382,0.7611486135191002,0.09705892412954593
141981,University of Hawaii-West Oahu,1,30612267,457973,7072070,38142310,0.8025803104216813,0.012006955006133609,0.18541273457218507
141990,Windward Community College,1,15773740,82797,2726883,18583420,0.8488071625136816,0.0044554231675332095,0.14673741431878523
142115,Boise State University,1,140827506,34974133,21859118,197660757,0.7124707409675659,0.1769401955695232,0.11058906346291085
142276,Idaho State University,1,121513281,17213329,12138640,150865250,0.8054424792985794,0.11409737497535052,0.08046014572607012
142285,University of Idaho,1,131068664,77369818,25159431,233597913,0.561086622379199,0.33120937172071396,0.10770400590008695
142328,Lewis-Clark State College,1,23139331,466335,5975583,29581249,0.7822296820529789,0.015764547331993995,0.2020057706150271
142461,Northwest Nazarene University,2,15500089,511247,11284256,27295592,0.5678605175516984,0.018730020583543307,0.41340946186475824
143084,Augustana College,2,27314197,237240,8465926,36017363,0.7583619322713882,0.006586823138606788,0.2350512445900051
143358,Bradley University,2,84267864,3425549,11984486,99677899,0.845401687288774,0.0343661838217517,0.12023212888947428
143853,Midwestern University-Downers Grove,2,73234551,14748220,6583467,94566238,0.7744259743101972,0.15595650532275587,0.06961752036704685
144005,Chicago State University,1,49920895,1997100,6994507,58912502,0.847373533719549,0.033899425965646476,0.1187270403148045
144050,University of Chicago,2,1410413346,397675680,114723411,1922812437,0.733515822375555,0.20681979809765502,0.059664379526790004
144218,City Colleges of Chicago-Wilbur Wright College,1,26962652,5866,9506137,36474655,0.7392160940247413,1.6082400231064558e-4,0.2606230819729481
144740,DePaul University,2,278198000,7973000,73832000,360003000,0.772765782507368,0.022147037663575026,0.20508717982905697
144892,Eastern Illinois University,1,62471680,986682,18520786,81979148,0.7620435381933952,0.01203576792478985,0.22592069388181493
144962,Elmhurst College,2,27431093,338465,13155152,40924710,0.670281915253645,0.008270431238242127,0.32144765350811283
145336,Governors State University,1,43619003,684631,6371149,50674783,0.8607634886172083,0.013510289723391612,0.1257262216594001
145558,Rosalind Franklin University of Medicine and Science,2,39114308,21302865,7732869,68150042,0.5739440043191756,0.31258770170677225,0.11346829397405214
145600,University of Illinois at Chicago,1,848575678,298113101,66151152,1212839931,0.6996600757532282,0.24579756436136008,0.054542359885411784
145619,Benedictine University,2,33528029,182211,22710367,56420607,0.5942514762381057,0.003229511515180969,0.4025190122467133
145628,Illinois College of Optometry,2,10771864,239093,2511669,13522626,0.7965807824604482,0.017680959304797753,0.1857382582347541
145637,University of Illinois at Urbana-Champaign,1,771622133,605523078,164290611,1541435822,0.5005866102156799,0.3928305475698229,0.10658284221449733
145646,Illinois Wesleyan University,2,34438417,210826,8990119,43639362,0.7891594977946744,0.004831097209899631,0.20600940499542592
145725,Illinois Institute of Technology,2,85868000,55717000,17244000,158829000,0.5406317486101405,0.35079865767586527,0.1085695937139943
145813,Illinois State University,1,155147439,26480414,55884909,237512762,0.6532172742785081,0.11149048908790847,0.2352922366335835
146481,Lake Forest College,2,20244726,472501,13823103,34540330,0.5861184881557299,0.013679689800300113,0.40020182204397003
146719,Loyola University Chicago,2,194659072,24265860,54808444,273733376,0.711126552576475,0.08864779426824444,0.20022565315528057
147590,National University of Health Sciences,2,11678350,439826,2068323,14186499,0.8232016933846751,0.03100313897036894,0.14579516764495595
147703,Northern Illinois University,1,198622795,20157069,29643323,248423187,0.7995340426898234,0.08114004672196722,0.11932591058820931
147767,Northwestern University,2,831628000,533365000,256213000,1621206000,0.5129687405548709,0.3289927375052893,0.15803852193983986
147776,Northeastern Illinois University,1,85349305,2056242,13675489,101081036,0.8443651586633916,0.020342510142060673,0.1352923311945477
148487,Roosevelt University,2,44312510,840159,16124903,61277572,0.7231440240484724,0.013710709686734978,0.2631452662647926
148496,Dominican University,2,34455014,203708,8682165,43340887,0.7949771309479661,0.004700134540393693,0.20032273451164023
148511,Rush University,2,41716125,171260810,11759708,224736643,0.1856222663253006,0.7620511177609786,0.05232661591372084
148654,University of Illinois at Springfield,1,41310965,1805605,13242643,56359213,0.7329940004662592,0.03203744168677444,0.23496855784696638
148982,Spertus College,2,2717255,870057,246802,3834114,0.7087048011613635,0.22692517749863464,0.06437002134000189
149222,Southern Illinois University-Carbondale,1,195615320,39314802,56709510,291639632,0.670743268528058,0.13480610207326005,0.194450629398682
149231,Southern Illinois University-Edwardsville,1,151180701,8673082,31478358,191332141,0.7901479605561932,0.04532997934727548,0.1645220600965313
149587,University of Illinois University Administration,1,981120,3232568,114526,4328214,0.22668010407988146,0.746859559162278,0.02646033675784053
149772,Western Illinois University,1,96134009,5846163,25061220,127041392,0.7567140715838504,0.04601778135428491,0.19726814706186468
149781,Wheaton College,2,44871000,1101000,26053000,72025000,0.6229920166608817,0.015286358903158626,0.36172162443595973
150136,Ball State University,1,217595736,13734574,23770841,255101151,0.8529782603764104,0.053839717877243135,0.09318202174634642
150145,Bethel College-Indiana,2,10568613,5290,7656991,18230894,0.5797089819073052,2.9016679050407514e-4,0.42000085130219067
150163,Butler University,2,76663000,711000,34882000,112256000,0.6829300883694412,0.0063337371721778795,0.31073617445838086
150455,Earlham College,2,28278622,483240,8792823,37554685,0.752998514033602,0.012867635555989885,0.23413385041040818
150534,University of Evansville,2,29395550,53389,13367490,42816429,0.6865483807629076,0.0012469279023713071,0.31220469133472106
150668,Goshen College,2,8601277,41461,5281236,13923974,0.6177314752239554,0.0029776700243766612,0.3792908547516679
150756,Hanover College,2,14414498,120688,10160321,24695507,0.5836890896793494,0.004887042813091466,0.41142386750755916
151102,Purdue University Fort Wayne,1,60656393,1118082,15740787,77515262,0.7825090367365333,0.014424024007040058,0.2030669392564267
151111,Indiana University-Purdue University-Indianapolis,1,525267811,211845324,41510145,778623280,0.6746109761835017,0.2720767917445263,0.05331223207197196
151306,University of Southern Indiana,1,62882723,586739,14288421,77757883,0.8086990099769048,0.007545717261875558,0.18375527276121958
151324,Indiana State University,1,90002000,10478000,16726000,117206000,0.7678958415098203,0.08939815367813934,0.14270600481204035
151333,Indiana University-Kokomo,1,18962797,1029334,4543681,24535812,0.7728620108435783,0.041952310361686826,0.18518567879473483
151342,Indiana University-South Bend,1,38389363,3089791,4590914,46070068,0.8332820997789715,0.06706721162208834,0.0996506885989402
151351,Indiana University-Bloomington,1,669278652,124886300,64762549,858927501,0.7792027280775121,0.14539795251008036,0.07539931941240754
151360,Indiana University-Northwest,1,29841132,2797611,3548029,36186772,0.8246419990155519,0.07731032212544407,0.09804767885900406
151379,Indiana University-Southeast,1,33386700,1733024,4363448,39483172,0.8455931554840629,0.04389272472839822,0.11051411978753885
151388,Indiana University-East,1,19614592,684251,5070277,25369120,0.7731680089809974,0.026971806668895097,0.19986018435010752
151777,Manchester University,2,15245588,541151,7766366,23553105,0.6472856975757548,0.0229757817493702,0.3297385206748749
151786,Marian University,2,42487759,269371,17107848,59864978,0.7097264614379379,0.004499642512188011,0.2857738960498741
151865,Anabaptist Mennonite Biblical Seminary,2,1048759,67225,429351,1545335,0.6786612611504949,0.04350189441124416,0.27783684443826095
152080,University of Notre Dame,2,435500000,147197000,60454000,643151000,0.6771349185494542,0.2288684927800781,0.09399658867046774
152530,Taylor University,2,23196427,297154,12621153,36114734,0.6422981545426861,0.00822805451093728,0.34947379094637665
152600,Valparaiso University,2,42011000,838000,24492000,67341000,0.6238547096122719,0.012444127648832064,0.3637011627388961
152673,Wabash College,2,15575235,1511502,13358221,30444958,0.5115866804611785,0.049647038435723906,0.4387662811030976
153144,Coe College,2,14611499,699643,11253741,26564883,0.5500306174885091,0.026337138394323063,0.42363224411716777
153162,Cornell College,2,14194333,170264,9449308,23813905,0.5960523064150965,0.007149772370386125,0.3967979212145173
153250,Dordt College,2,15207885,865004,7128984,23201873,0.6554593674398614,0.037281645322341,0.30725898723779754
153269,Drake University,2,54617696,914389,29091666,84623751,0.64541804581553,0.010805347070942294,0.34377660711352775
153384,Grinnell College,2,48168000,1226000,25813000,75207000,0.6404722964617655,0.01630167404629888,0.3432260294919356
153603,Iowa State University,1,331633423,200827634,41324460,573785517,0.5779745447984181,0.35000471090663654,0.07202074429494532
153658,University of Iowa,1,426638000,408905000,54234000,889777000,0.479488680871724,0.45955896814595115,0.060952350982324786
153825,Loras College,2,10037930,522422,9867117,20427469,0.4913937208765315,0.02557448502308338,0.4830317941003851
153834,Luther College,2,29361078,385790,13551939,43298807,0.6781036253493081,0.008909945255535562,0.3129864293951563
153861,Maharishi University of Management,2,11447000,388000,2393000,14228000,0.8045403429856621,0.027270171492831036,0.1681894855215069
154095,University of Northern Iowa,1,99430497,3451184,12257402,115139083,0.8635686025048506,0.02997404452144195,0.10645735297370745
154156,Des Moines University-Osteopathic Medical Center,2,22077403,1998813,4388317,28464533,0.7756109330864484,0.07022117664814666,0.15416789026540503
154174,Palmer College of Chiropractic,2,31713221,2928183,10193570,44834974,0.7073322045419275,0.06531024195530927,0.22735755350276327
154572,Western Iowa Tech Community College,1,23490141,234156,3637307,27361604,0.8585074544606376,0.008557831624198639,0.13293471391516373
154712,Benedictine College,2,15899020,278,6143064,22042362,0.7212938431915781,1.2612078505924184e-5,0.278693544729916
155025,Emporia State University,1,37216165,752405,7461745,45430315,0.8191923168483424,0.016561738565977365,0.1642459445856803
155061,Fort Hays State University,1,55402813,1081570,12975701,69460084,0.7976208753217171,0.015571101238518514,0.18680802343976435
155186,Highland Community College,1,5969870,68314,3600136,9638320,0.6193890636542468,0.007087749732318496,0.3735231866134347
155292,Kansas City Kansas Community College,1,33151318,164533,7197981,40513832,0.818271596722818,0.004061156199690022,0.17766724707749196
155317,University of Kansas,1,517951830,320433418,48687274,887072522,0.5838889348440442,0.3612257285092639,0.054885336646691894
155399,Kansas State University,1,237609475,212973215,41013755,491596445,0.48334254125861303,0.4332277362176612,0.08342972252372574
155520,MidAmerica Nazarene University,2,10820318,2712,5631890,16454920,0.6575734187707992,1.648139279923573e-4,0.3422617673012084
155681,Pittsburg State University,1,41611787,3090474,10184276,54886537,0.7581419647590446,0.05630659482124004,0.1855514404197153
156082,Washburn University,1,45404056,179114,14860380,60443550,0.7511811599417969,0.0029633269389372397,0.24585551311926582
156125,Wichita State University,1,93982704,88696689,39636699,222316092,0.4227435951869827,0.398966571434694,0.17828983337832333
156620,Eastern Kentucky University,1,102672549,972723,22265818,125911090,0.8154369007527454,0.007725475174585495,0.17683762407266906
157058,Kentucky State University,1,11996648,9069501,8486407,29552556,0.4059428226783497,0.30689396206541325,0.28716321525623706
157085,University of Kentucky,1,342994721,336158166,49207176,728360063,0.4709136846235898,0.4615274547253698,0.06755886065104039
157289,University of Louisville,1,302794000,151078000,36141000,490013000,0.6179305446998345,0.30831426921326577,0.07375518608689974
157298,Louisville Presbyterian Theological Seminary,2,2259302,246097,550485,3055884,0.7393284561848552,0.0805321798864093,0.1801393639287355
157386,Morehead State University,1,52305372,1536342,20404322,74246036,0.7044870651410938,0.020692579466464713,0.27482035539244143
157401,Murray State University,1,71520334,3094247,20586296,95200877,0.7512570918858237,0.032502295120663646,0.21624061299351266
157447,Northern Kentucky University,1,93074000,2464000,30307000,125845000,0.7395923556756328,0.019579641622631015,0.24082800270173627
157535,University of Pikeville,2,19349131,124427,9801395,29274953,0.6609449039935265,0.0042502886341098485,0.3348048073723637
157757,Spalding University,2,15259471,265495,4949196,20474162,0.7453038126786337,0.012967319492734306,0.241728867828632
157818,Transylvania University,2,12150999,42672,8865427,21059098,0.5769952255315018,0.002026297612556815,0.4209784768559413
157951,Western Kentucky University,1,142270055,8267482,39954781,190492318,0.7468545529484292,0.043400605792407856,0.209744841259163
158802,Dillard University,2,10339771,2734832,6973205,20047808,0.5157556876043505,0.13641551235925645,0.347828800036393
159009,Grambling State University,1,18792824,1079544,6021757,25894125,0.7257562864163203,0.041690692386786576,0.2325530211968931
159373,Louisiana State University Health Sciences Center-New Orleans,1,238232530,40639028,6945361,285816919,0.8335144428591367,0.14218552261421585,0.02430003452664746
159382,Louisiana State University-Alexandria,1,13431147,35099,2163483,15629729,0.8593333256130032,0.002245656338635174,0.13842101804836154
159391,Louisiana State University and Agricultural & Mechanical College,1,378473385,234065320,33942268,646480973,0.5854362321657995,0.36206064799373455,0.0525031198404659
159407,Louisiana State University-Eunice,1,8714658,11360,1796414,10522432,0.8281980819643215,0.00107959832859932,0.17072231970707913
159416,Louisiana State University-Shreveport,1,31638198,573702,3528022,35739922,0.8852341087929627,0.01605213352172397,0.09871375768531336
159647,Louisiana Tech University,1,57811965,22920594,7614920,88347479,0.6543702848612126,0.25943687651800457,0.08619283862078284
159656,Loyola University New Orleans,2,45049000,728000,12001000,57778000,0.7796912319568001,0.012599951538647928,0.20770881650455192
159717,McNeese State University,1,29973726,368515,5406658,35748899,0.8384517240656838,0.010308429358901375,0.1512398465754148
159939,University of New Orleans,1,40983287,11842212,8173067,60998566,0.6718729584561054,0.1941391868130146,0.13398785473088007
159966,Nicholls State University,1,31189219,1599260,7411899,40200378,0.7758439236566382,0.03978221299312161,0.18437386335024014
159993,University of Louisiana at Monroe,1,44732197,7221153,10379956,62333306,0.7176291435593036,0.11584742513095647,0.16652343130973993
160038,Northwestern State University of Louisiana,1,42917180,393168,11904423,55214771,0.7772771528836007,0.007120703262538207,0.21560214385386114
160074,Franciscan Missionaries of Our Lady University,2,10515347,681888,2730648,13927883,0.754985305376273,0.04895848134278555,0.19605621328094155
160612,Southeastern Louisiana University,1,69998432,1720525,12571623,84290580,0.830441930759048,0.02041183012384065,0.1491462391171113
160621,Southern University and A & M College,1,31593702,6650794,7788850,46033346,0.6863220848643068,0.1444777444594186,0.16920017067627455
160630,Southern University at New Orleans,1,10475332,425146,3478959,14379437,0.7284938902684438,0.02956624796923551,0.24193986176232074
160658,University of Louisiana at Lafayette,1,115542374,62299731,16876776,194718881,0.5933804334054282,0.3199470471484478,0.08667251944612397
160755,Tulane University of Louisiana,2,350182000,158366000,89739000,598287000,0.5853077202078601,0.26469904911856684,0.14999323067357306
160904,Xavier University of Louisiana,2,28086888,8965122,11311054,48363064,0.5807507977575614,0.18537125770195206,0.23387794454048652
160977,Bates College,2,44513298,2094432,19235206,65842936,0.6760527507461089,0.031809517121168474,0.29213773213272265
161004,Bowdoin College,2,63335000,2940000,36013000,102288000,0.6191830908806507,0.028742374472078835,0.35207453464727045
161086,Colby College,2,50876000,2232000,31415000,84523000,0.601919004294689,0.02640701347562202,0.37167398222968895
161217,University of Maine at Augusta,1,18048000,117000,6862000,25027000,0.7211411675390578,0.004674951052862908,0.27418388140807926
161226,University of Maine at Farmington,1,22223000,568000,6389000,29180000,0.7615832762165867,0.019465387251542152,0.21895133653187115
161235,University of Maine at Fort Kent,1,6410000,219000,3496000,10125000,0.6330864197530864,0.02162962962962963,0.34528395061728395
161244,University of Maine at Machias,1,4777000,493000,2193000,7463000,0.6400911161731208,0.06605922551252848,0.2938496583143508
161253,University of Maine,1,100899000,82734000,30836000,214469000,0.4704596002219435,0.3857620448642927,0.14377835491376376
161299,Maine Maritime Academy,1,11259768,266145,5648884,17174797,0.6555983165332318,0.015496253027037233,0.328905430439731
161341,University of Maine at Presque Isle,1,7140000,75000,4055000,11270000,0.6335403726708074,0.006654835847382431,0.3598047914818101
161457,University of New England,2,77453396,6840586,24417981,108711963,0.7124643310874628,0.06292394885740404,0.22461172005513322
161554,University of Southern Maine,1,56859000,8706000,18173000,83738000,0.679010723924622,0.10396713558957701,0.21702214048580096
161873,University of Baltimore,1,41823165,14615860,9900969,66339994,0.630436671429304,0.22031747545831856,0.14924585311237742
162007,Bowie State University,1,46073165,1135250,10369805,57578220,0.8001839063451424,0.019716656749722377,0.1800994369051353
162122,College of Southern Maryland,1,27230200,114897,6299676,33644773,0.8093441438882646,0.003415002978322963,0.18724085313341243
162283,Coppin State University,1,25186192,692352,6559991,32438535,0.7764281586699276,0.021343503952937454,0.20222833737713494
162584,Frostburg State University,1,37076283,183721,5535743,42795747,0.8663543832988825,0.004292973318119672,0.12935264338299785
162654,Goucher College,2,26271563,141548,11053000,37466111,0.7012087003105286,0.0037780275620279886,0.2950132721274434
162928,Johns Hopkins University,2,2198650000,3221889000,136198000,5556737000,0.39567285621039827,0.5798167161771378,0.024510427612463935
163046,Loyola University Maryland,2,70688301,1459106,34998467,107145874,0.6597388995118935,0.013617939221812685,0.32664316126629384
163259,"University of Maryland, Baltimore",1,217021404,541711148,5870534,764603086,0.2838353754695675,0.7084867402693167,0.007677884261115838
163268,University of Maryland-Baltimore County,1,130105200,73069647,24423265,227598112,0.5716444607413966,0.32104680639881583,0.10730873285978752
163286,University of Maryland-College Park,1,535994795,483330489,59810420,1079135704,0.496688964152742,0.44788666263978977,0.055424373207468264
163338,University of Maryland Eastern Shore,1,43148714,11661988,6047056,60857758,0.7090092605777557,0.19162697383626917,0.09936376558597508
163426,Montgomery College,1,112066721,252707,38131505,150450933,0.7448722235574305,0.0016796638941414873,0.253448112548428
163453,Morgan State University,1,67249029,26310892,9096749,102656670,0.6550867956266261,0.2562998780303316,0.0886133263430423
163532,Ner Israel Rabbinical College,2,2638895,36000,89500,2764395,0.9546012780373282,0.013022740961403852,0.03237598100126791
163657,Prince George's Community College,1,55304473,51894,13504553,68860920,0.8031329381019017,7.536059640213927e-4,0.19611345593407697
163851,Salisbury University,1,65929002,1857135,9348882,77135019,0.854722055620418,0.024076418520101745,0.12120152585948024
163912,St. Mary's College of Maryland,1,25013757,471999,9789411,35275167,0.7091038576798233,0.013380489453104502,0.2775156528670722
164076,Towson University,1,136984263,4922360,26563500,168470123,0.8131071584722473,0.029217999680572444,0.15767484184718022
164085,Maryland University of Integrative Health,2,5210421,215707,1004417,6430545,0.8102611831501062,0.03354412417610016,0.1561946926737936
164155,United States Naval Academy,1,187188092,13862199,134852911,335903202,0.5572679595950979,0.04126843363642601,0.4014636067684761
164270,McDaniel College,2,22611000,161000,10715000,33487000,0.6752172484844865,0.004807835876608833,0.3199749156389046
164368,Hult International Business School,2,12217404,295821,25605539,38118764,0.3205089231119876,0.007760508709044186,0.6717305681789683
164465,Amherst College,2,63154938,5852929,36435062,105442929,0.5989490106064864,0.05550802747522311,0.3455429619182904
164580,Babson College,2,57995411,1845071,33211851,93052333,0.6232558510918796,0.019828315320154305,0.356915833587966
164739,Bentley University,2,77262000,2352000,38141000,117755000,0.6561250053076303,0.019973674153963738,0.32390132053840603
164915,Boston Graduate School of Psychoanalysis Inc,2,623263,20000,182088,825351,0.755149021446633,0.024232114579130576,0.2206188639742364
164924,Boston College,2,315140269,47221066,65845170,428206505,0.7359539505360854,0.1102763863897864,0.1537696630741282
164988,Boston University,2,1106242000,237991000,89793000,1434026000,0.7714239490776318,0.1659600314080777,0.06261601951429054
165015,Brandeis University,2,131152669,48502231,37170071,216824971,0.6048780654512343,0.22369301273883255,0.17142892180993305
165334,Clark University,2,43796000,8205000,14953000,66954000,0.6541207396122711,0.1225468231920423,0.2233324371956866
165662,Emerson College,2,64718818,2778192,25496119,92993129,0.6959526869990578,0.02987523949215646,0.2741720735087858
165820,Fitchburg State University,1,50818499,106694,19023660,69948853,0.7265093968016888,0.0015253145037274593,0.27196528869458375
165866,Framingham State University,1,35281056,108001,14553219,49942276,0.7064366870264382,0.0021625165821437535,0.29140079639141797
165936,Gordon College,2,19738774,309092,12816990,32864856,0.6006043050972139,0.009404940036858826,0.3899907548659273
165945,Gordon-Conwell Theological Seminary,2,8468507,320286,2446915,11235708,0.7537136956567401,0.028506080791704448,0.21778022355155546
165981,Greenfield Community College,1,10787458,21031,4444739,15253228,0.7072245953446706,0.0013787901157709043,0.29139661453955845
166018,Hampshire College,2,16065857,2946309,7592582,26604748,0.6038717976204849,0.11074372890132242,0.2853844734781927
166027,Harvard University,2,1293726000,1138659000,209528000,2641913000,0.4896928854205267,0.4309979170396603,0.07930919753981301
166124,College of the Holy Cross,2,68749978,591845,40018795,109360618,0.6286538907452041,0.0054118659058784765,0.36593424334891744
166391,Lasell College,2,17563683,163438,11876839,29603960,0.5932882965657297,0.005520815458472448,0.4011908879757978
166513,University of Massachusetts-Lowell,1,180838000,71521000,49034000,301393000,0.6000072994396021,0.23730146353764023,0.16269123702275767
166629,University of Massachusetts-Amherst,1,536999370,151920765,78928256,767848391,0.6993559878410945,0.1978525536820458,0.10279145847685967
166638,University of Massachusetts-Boston,1,205551000,44971000,36672000,287194000,0.7157217769173451,0.15658753316573465,0.12769068991692026
166656,MCPHS University,2,98609414,127250,22703580,121440244,0.81199947193781985,0.001047840450649951,0.18695268761153017
166683,Massachusetts Institute of Technology,2,925388000,1581428000,100307000,2607123000,0.3549460458904317,0.606579743264894,0.03847421084467438
166708,University of Massachusetts Medical School Worcester,1,72664647,292558473,9227010,374450130,0.19405694157456962,0.781301566112422,0.024641492313008412
166850,Merrimack College,2,41326959,930201,29817801,72074961,0.5733885724891339,0.012906021551645377,0.41370540595922073
166869,MGH Institute of Health Professions,2,31411000,3705000,3248000,38364000,0.8187623813992284,0.096574913981858,0.08466270461891356
166939,Mount Holyoke College,2,57409448,2694773,20198824,80303045,0.7149099763277967,0.03355754442437395,0.2515324792478293
167093,New England College of Optometry,2,13508760,1323037,1794647,16626444,0.8124864222319578,0.07957426133934592,0.10793931642869636
167358,Northeastern University,2,472582000,170142000,136771000,779495000,0.6062668779145473,0.2182720864149225,0.17546103567053029
167783,Simmons University,2,109689897,988312,11454591,122132800,0.8981198908073834,0.008092109572530884,0.09378799962008567
167835,Smith College,2,87942957,5537245,30609731,124089933,0.7087033965922118,0.04462283817979014,0.246673765227998
167987,University of Massachusetts-Dartmouth,1,99677000,14898000,23625000,138200000,0.7212518089725036,0.10780028943560058,0.1709479015918958
167996,Stonehill College,2,36505946,696212,19477258,56679416,0.6440776665729936,0.012283330512791452,0.3436390029142149
168005,Suffolk University,2,84420135,948659,30701972,116070766,0.7273160840516897,0.008173108808466036,0.2645108071398443
168148,Tufts University,2,303325071,163921025,35282488,502528584,0.6035976472932334,0.3261924400304362,0.07020991267633046
168218,Wellesley College,2,93475000,12501000,41893000,147869000,0.6321473736888733,0.08454104646680508,0.28331157984432165
168281,Wheaton College,2,31022707,323865,14767712,46114284,0.6727353069170499,0.007023095056620634,0.32024159802632957
168421,Worcester Polytechnic Institute,2,137523000,32320000,26719000,196562000,0.6996418432860878,0.16442649138694151,0.13593166532697062
168546,Albion College,2,20625134,710225,15098405,36433764,0.5660994565370737,0.019493593909210148,0.41440694955371615
168740,Andrews University,2,36698008,1920506,6235689,44854203,0.8181620794822728,0.04281663415131911,0.13902128636640806
169080,Calvin College,2,45567000,3814000,19574000,68955000,0.660822275396998,0.05531143499383656,0.2838662896091654
169248,Central Michigan University,1,168893746,18114018,28194771,215202535,0.7848129948840984,0.08417195457293289,0.13101505054296875
169716,University of Detroit Mercy,2,68344000,1760316,14242333,84346649,0.8102752250418389,0.020870017017510678,0.16885475794065039
169798,Eastern Michigan University,1,121727159,6398911,18507130,146633200,0.8301473267991151,0.04363889623905091,0.12621377696183403
169813,Creative Hair School of Cosmetology,3,97521,8774,29830,136125,0.7164077134986226,0.064455463728191,0.2191368227731864
169910,Ferris State University,1,99912530,366133,19011096,119289759,0.8375616719956656,0.003069274370820047,0.15936905363351433
169983,Kettering University,2,24123334,3155967,6326114,33605415,0.7178406813306725,0.09391245428750099,0.18824686438182656
170082,Grand Valley State University,1,212492539,8770188,38971497,260234224,0.8165434036070521,0.03370113225384221,0.1497554641391057
170301,Hope College,2,39414000,6402000,17027000,62843000,0.6271820250465445,0.10187292140731664,0.2709450535461388
170639,Lake Superior State University,1,15881745,824092,3017300,19723137,0.8052342282061925,0.04178300845347269,0.15298276334033475
170675,Lawrence Technological University,2,25993059,419546,15313627,41726232,0.6229428767975024,0.010054730079629525,0.36700239312286814
170967,Rochester College,2,5795462,164061,2774762,8734285,0.663530214551048,0.018783563852106954,0.31768622159684506
170976,University of Michigan-Ann Arbor,1,1240737000,955414000,126530000,2322681000,0.5341831271707135,0.4113410321951228,0.05447584063416371
171100,Michigan State University,1,805769161,469370923,64890240,1340030324,0.601306661922973,0.3502688816764418,0.04842445640058515
171128,Michigan Technological University,1,77864705,66346769,16495420,160706894,0.4845137819663169,0.41284332830177156,0.10264288973191156
171137,University of Michigan-Dearborn,1,78464000,4684000,13789000,96937000,0.8094329306663091,0.04832004291447022,0.14224702641922074
171146,University of Michigan-Flint,1,65969000,1134000,10143000,77246000,0.8540118582191958,0.014680371799187013,0.13130776998161717
171456,Northern Michigan University,1,55635130,1527384,21312961,78475475,0.7089492608996633,0.019463201720027818,0.27158753738030894
171571,Oakland University,1,145792463,12877478,43050968,201720909,0.7227434365765226,0.06383809226241391,0.21341847116106344
171881,Kuyper College,2,1967885,27103,333749,2328737,0.8450439014796433,0.011638497606213154,0.14331760091414358
172051,Saginaw Valley State University,1,56808945,2331796,15183939,74324680,0.7643348750374708,0.031373105138158684,0.2042920198243706
172200,Schoolcraft College,1,41621017,663671,11745597,54030285,0.7703275487071741,0.012283314811313692,0.21738913648151217
172644,Wayne State University,1,320063000,186783000,48611000,555457000,0.5762156206511035,0.3362690541302027,0.08751532521869379
172699,Western Michigan University,1,223116381,19499964,24780880,267397225,0.8344005103269115,0.07292507990686889,0.09267440976621953
172918,Alexandria Technical & Community College,1,13996000,345000,3386000,17727000,0.7895300953348,0.019461837874428838,0.19100806679077115
173124,Bemidji State University,1,28814000,205000,15866000,44885000,0.6419516542274702,0.0045672273588058376,0.353481118413724
173203,Central Lakes College-Brainerd,1,16993000,267000,7902000,25162000,0.6753437723551386,0.010611239170177252,0.31404498847468404
173258,Carleton College,2,63877656,3823487,16997052,84698195,0.7541796610895899,0.045142485031705815,0.20067785387870427
173300,Concordia College at Moorhead,2,27471797,317055,11849796,39638648,0.6930558529645108,0.007998633051258459,0.29894551398423075
173416,Dakota County Technical College,1,16298000,10000,5505000,21813000,0.7471691193325082,4.584422133590061e-4,0.2523724384541329
173638,Minnesota West Community and Technical College,1,15535000,97000,5561000,21193000,0.7330250554428349,0.004576982966073704,0.2623979615910914
173647,Gustavus Adolphus College,2,36137627,133174,14833151,51103952,0.7071395769939671,0.002605943274210965,0.2902544797318219
173665,Hamline University,2,24181255,94723,13724645,38000623,0.6363383831891387,0.002492669659652685,0.36116894715120856
173683,Hazelden Betty Ford Graduate School of Addiction Studies,2,1372722,57851,195745,1626318,0.8440673964132476,0.035571763947764214,0.12036083963898819
173799,Inver Hills Community College,1,18770000,10000,5897000,24677000,0.7606273047777282,4.0523564452729264e-4,0.23896745957774446
173805,Itasca Community College,1,4977000,5000,3189000,8171000,0.6091053726594052,6.119202056051891e-4,0.3902827071349896
173902,Macalester College,2,46775000,1822000,24981000,73578000,0.6357199162793227,0.02476283671749708,0.3395172470031803
173920,Minnesota State University-Mankato,1,101504000,3533000,34954000,139991000,0.7250751834046475,0.02523733668592981,0.24968747990942275
173957,Mayo Clinic College of Medicine and Science,2,36949728,11787,11853262,48814777,0.7569373511631529,2.414637682355898e-4,0.2428211850686115
174020,Metropolitan State University,1,35321000,694000,8395000,44410000,0.7953388876379194,0.01562711101103355,0.18903400135104706
174066,University of Minnesota-Twin Cities,1,795002202,886948175,140685224,1822635601,0.43618274632834847,0.48662945819415054,0.07718779547750093
174075,University of Minnesota-Crookston,1,12795975,555569,3744694,17096238,0.7484672943837117,0.03249656444885711,0.21903614116743111
174233,University of Minnesota-Duluth,1,78563449,28291968,20264117,127119534,0.6180281387752727,0.22256192348848605,0.15940993773624124
174251,University of Minnesota-Morris,1,17110695,1117631,6296787,24525113,0.6976805774554433,0.04557088075394393,0.25674854179061274
174358,Minnesota State University Moorhead,1,41790000,202000,16878000,58870000,0.7098692033293698,0.0034312892814676406,0.28669950738916256
174376,North Hennepin Community College,1,23085000,3000,7914000,31002000,0.7446293787497581,9.676795045480937e-5,0.25527385329978713
174428,Normandale Community College,1,37253000,376000,9339000,46968000,0.7931570430931698,0.00800545051950264,0.19883750638732753
174473,Northland Community and Technical College,1,17082000,358000,5027000,22467000,0.760315128855655,0.01593448168424801,0.22375038946009704
174507,Northwestern Health Sciences University,2,9550726,23514,2619011,12193251,0.7832797012051995,0.0019284438579998066,0.2147918549368007
174604,Rainy River Community College,1,1048000,90000,1115000,2253000,0.46515756768752775,0.03994673768308921,0.49489569462938304
174783,Saint Cloud State University,1,82832000,3081000,26589000,112502000,0.736271355175908,0.027386179801247978,0.23634246502284403
174817,Saint Mary's University of Minnesota,2,28593225,154350,14045004,42792579,0.6681818592892006,0.0036069338097149974,0.3282112069010844
174844,St Olaf College,2,54977053,1227229,20837585,77041867,0.7135996976812621,0.015929377723932884,0.27047092459480504
174914,University of St Thomas,2,130121164,1345034,33554395,165020593,0.7885147037376117,0.00815070395486944,0.20333459230751885
175005,St Catherine University,2,47556107,5050082,13865763,66471952,0.7154311791535775,0.07597312622924027,0.2085956946171823
175078,Southwest Minnesota State University,1,20907000,24000,10915000,31846000,0.6565031715129058,7.536268291151165e-4,0.342743201657979
175157,Vermilion Community College,1,3179000,53000,2058000,5290000,0.600945179584121,0.01001890359168242,0.3890359168241966
175227,Dunwoody College of Technology,2,16425244,90000,1931175,18446419,0.8904299528271585,0.004878995755219482,0.10469105141762203
175236,Ridgewater College,1,23194000,30000,5443000,28667000,0.8090836153067987,0.0010464994593086126,0.18986988523389262
175263,Minnesota State College Southeast,1,9451000,74000,2244000,11769000,0.8030418897102558,0.006287704987679497,0.19067040530206475
175272,Winona State University,1,59482000,559000,16501000,76542000,0.7771158318308903,0.0073031799534895876,0.2155809882156202
175315,Century College,1,37160000,181000,12626000,49967000,0.7436908359517281,0.003622390777913423,0.25268677327035843
175342,Alcorn State University,1,17301870,6952563,8101924,32356357,0.534728616079987,0.21487471534573563,0.2503966685742774
175616,Delta State University,1,21402694,206620,6557616,28166930,0.7598518546394655,0.007335552720868053,0.23281259263966644
175856,Jackson State University,1,52662259,17827736,19936334,90426329,0.5823774953863271,0.19715204849242526,0.2204704561212476
176017,University of Mississippi,1,330922974,160891994,24959518,516774486,0.6403624462218516,0.31133888835216217,0.04829866542598622
176035,Mississippi University for Women,1,17394903,49725,5034141,22478769,0.7738369925862043,0.0022120873256004365,0.22395092008819523
176044,Mississippi Valley State University,1,17029679,30407,7007325,24067411,0.7075825064856374,0.0012634096787560573,0.2911540838356066
176080,Mississippi State University,1,154057737,176692756,21462768,352213261,0.437399025132106,0.5016641210451187,0.060936853822775285
176372,University of Southern Mississippi,1,91023329,60220179,11744483,162987991,0.5584664762203247,0.3694761720205509,0.0720573517591244
176406,Tougaloo College,2,3862978,3934847,4160669,11958494,0.3230321476935139,0.32904201816717055,0.34792583413931555
176479,William Carey University,2,38750219,219696,3030245,42000160,0.9226207471590584,0.005230837215858226,0.07214841562508334
176965,University of Central Missouri,1,85149767,587092,23803141,109540000,0.777339483293774,0.005359612926784736,0.2173009037794413
177038,Cleveland University-Kansas City,2,6656035,171422,2889238,9716695,0.6850101809308617,0.017642006875794702,0.2973478121933435
177214,Drury University,2,14516638,13648,11399179,25929465,0.5598510420481101,5.263510064708239e-4,0.43962260694541905
177551,Harris-Stowe State University,1,10276359,49855,3205828,13532042,0.7594093337871698,0.0036842185384881308,0.23690644767434213
177719,Barnes-Jewish College Goldfarb School of Nursing,2,9371295,1748242,3108472,14228009,0.6586511858405487,0.12287327060307594,0.21847554355637533
177834,A T Still University of Health Sciences,2,73958235,3808112,6489738,84256085,0.8777791538735749,0.04519687806524597,0.0770239680611792
177940,Lincoln University,1,12921208,4783067,7515531,25219806,0.5123436714778853,0.18965518608668125,0.29800114243543346
177986,Logan University,2,10285913,166458,4435999,14888370,0.6908689802846114,0.011180404570816012,0.29795061514457255
178387,Missouri Western State University,1,36548035,186096,11602529,48336660,0.7561141998640369,0.0038499970829593937,0.24003580305300365
178396,University of Missouri-Columbia,1,375873630,158809781,47403090,582086501,0.6457350056293437,0.27282848979863217,0.08143650457202409
178402,University of Missouri-Kansas City,1,157355925,20700071,18048255,196104251,0.8024095561294079,0.10555646241447361,0.09203398145611846
178411,Missouri University of Science and Technology,1,107639072,31215636,24178604,163033312,0.6602274754744601,0.19146783940695505,0.14830468511858486
178420,University of Missouri-St Louis,1,96387845,10462575,18682541,125532961,0.767828976805542,0.08334524189228676,0.1488257813021713
178439,University of Missouri-System Office,1,6709004,2432315,4864389,14005708,0.4790192684297002,0.17366597961345473,0.347314751956845
178615,Truman State University,1,48208980,646825,10681686,59537491,0.8097247497379424,0.010864162885197834,0.17941108737685973
178624,Northwest Missouri State University,1,44321370,293087,16595397,61209854,0.7240888043941421,0.004788232299982287,0.27112296330587554
179043,Rockhurst University,2,17637678,46595,5638736,23323009,0.7562350981384949,0.001997812546399995,0.2417670893151051
179159,Saint Louis University,2,246175268,39132618,28480641,313788527,0.7845260320814725,0.12471016188555549,0.090763806032972
179265,St. Louis College of Pharmacy,2,20783251,4989891,8652765,34425907,0.6037096132282005,0.14494581072330207,0.2513445760484974
179344,Missouri State University-West Plains,1,5185413,657,2019062,7205132,0.7196832757540043,9.118500535451676e-5,0.28022553924064125
179557,Southeast Missouri State University,1,65663442,961018,19856180,86480640,0.759284875782603,0.011112521831475809,0.22960260238592128
179566,Missouri State University-Springfield,1,133279309,11515484,14888376,159683169,0.8346484468879748,0.07211457583234711,0.09323697727967811
179812,Kansas City University of Medicine and Biosciences,2,26154681,1153756,4704963,32013400,0.8169916659898667,0.03603978334072607,0.14696855066940717
179867,Washington University in St Louis,2,2170532000,541107000,102527000,2814166000,0.771287834477426,0.19227970205026995,0.03643246347230405
180054,Blackfeet Community College,2,2691107,556773,1006349,4254229,0.6325722005091875,0.13087518325882316,0.2365526162319894
180160,Chief Dull Knife College,1,2878341,88120,1480288,4446749,0.6472910883883934,0.019816724532911573,0.332892187078695
180179,Montana State University Billings,1,24301541,557780,9922339,34781660,0.6986883604750319,0.016036612398603173,0.2852750271263649
180203,Aaniiih Nakoda College,1,2093873,190079,608904,2892856,0.723808236566217,0.06570634694571731,0.21048541648806576
180212,Fort Peck Community College,1,3282372,166796,562079,4011247,0.8182921669994393,0.0415820815821115,0.14012575141844918
180328,Little Big Horn College,1,1188460,128126,992005,2308591,0.5147988534998187,0.05549965325170201,0.4297014932484793
180416,Montana Technological University,1,18892303,11376388,4510898,34779589,0.5432008699125226,0.3270995525565296,0.12969957753094782
180461,Montana State University,1,123099819,133410529,37617728,294128076,0.4185245443892952,0.45357971538901987,0.12789574022168493
180489,The University of Montana,1,89490139,57758298,27566557,174814994,0.5119134060090978,0.33039670498744517,0.15768988900345698
180522,Montana State University-Northern,1,8374372,412415,4760919,13547706,0.6181394842787407,0.03044168510890331,0.35141883061235607
180647,Salish Kootenai College,2,10718816,692444,1515435,12926695,0.8292000391438028,0.05356697903060295,0.11723298182559425
180692,The University of Montana-Western,1,9876050,95593,3772713,13744356,0.7185531282804375,0.006955073049621241,0.27449179866994133
180948,Chadron State College,1,12324485,81457,6760498,19166440,0.6430242131559121,0.004249980695423876,0.352725806148664
181002,Creighton University,2,138277000,19457000,27771000,185505000,0.7454084795558071,0.10488666073690736,0.14970485970728553
181215,University of Nebraska at Kearney,1,50904962,2754328,6956935,60616225,0.8397910295469571,0.04543879134670627,0.11477017910633663
181394,University of Nebraska at Omaha,1,117445705,12336062,12750867,142532634,0.8239916831958638,0.08654903550017885,0.08945928130395737
181428,University of Nebraska Medical Center,1,183047214,146328075,748036,330123325,0.5544813108858636,0.4432527601616759,0.0022659289524604178
181464,University of Nebraska-Lincoln,1,280031599,277936752,21639315,579607666,0.4831399158892422,0.4795256659010442,0.0373344182097136
181534,Peru State College,1,8094800,19423,4845548,12959771,0.6246098021330778,0.00149871475352458,0.3738914831133976
181765,Nebraska College of Technical Agriculture,1,2585095,2310,742193,3329598,0.776398532195178,6.937774470071161e-4,0.22290769035781496
181783,Wayne State College,1,22013855,60,10435073,32448988,0.6784142235807169,1.8490561246470922e-6,0.32158392736315844
182005,College of Southern Nevada,1,122182000,179000,30241000,152602000,0.8006579206039239,0.0011729859372747408,0.19816909345880132
182281,University of Nevada-Las Vegas,1,358173000,47468000,87405000,493046000,0.7264494590768407,0.09627499259703963,0.17727554832611966
182290,University of Nevada-Reno,1,228545716,95761841,50128513,374436070,0.6103731299177454,0.25574950885474257,0.1338773612275121
182564,Western Nevada College,1,10575000,68000,3175000,13818000,0.7653061224489796,0.004921117383123462,0.22977276016789694
182652,Continental Academie of Hair Design-Hudson,3,144760,8034,108426,261220,0.5541688997779649,0.030755684863333587,0.41507541535870146
182670,Dartmouth College,2,192452133,152035035,91795061,436282229,0.4411184325364763,0.3484786335406753,0.21040293392284837
182829,University of New Hampshire-School of Law,1,5362426,1856,943612,6307894,0.850113524418768,2.942344941116639e-4,0.14959224108712035
183044,University of New Hampshire-Main Campus,1,167526401,119906034,26231789,313664224,0.5340947044059446,0.38227513635727867,0.08363015923677672
183062,Keene State College,1,34062313,3883578,11662968,49608859,0.6866175454670304,0.07828396133843755,0.23509849319453205
183071,University of New Hampshire at Manchester,1,9334863,783987,2709919,12828769,0.7276507200340111,0.061111631209510436,0.21123764875647852
183080,Plymouth State University,1,39996986,2267987,12793859,55058832,0.7264408732826007,0.04119206524395577,0.23236706147344352
183099,NHTI-Concord's Community College,1,14430978,7715,2081900,16520593,0.8735145282012576,4.669929221063675e-4,0.12601847887663598
183105,White Mountains Community College,1,3814693,111113,828003,4753809,0.8024497829004068,0.023373467465773234,0.17417674963381996
183114,River Valley Community College,1,3445355,1556,1439296,4886207,0.7051185101245199,3.1844741739349154e-4,0.2945630424580866
183123,Lakes Region Community College,1,3975845,1724,600896,4578465,0.868379467791061,3.765454142381781e-4,0.13124398679470084
183132,Manchester Community College,1,10870689,5450,1769614,12645753,0.8596316091260046,4.3097473120026937e-4,0.13993741614279515
183141,Nashua Community College,1,4913025,51185,845374,5809584,0.8456758693909925,0.008810441504933916,0.14551368910407356
183150,Great Bay Community College,1,8014828,142858,1774130,9931816,0.806985147529918,0.014383875013391308,0.1786309774566907
183327,University System of New Hampshire System Office,1,1811634,417388,228934,2457956,0.737048995181362,0.16981101370406956,0.09313999111456836
183859,Brookdale Community College,1,36756680,1545931,7701149,46003760,0.7989929518804549,0.03360444885374587,0.16740259926579915
184603,Fairleigh Dickinson University-Metropolitan Campus,2,74657000,612000,41056000,116325000,0.6417966903073286,0.0052611218568665375,0.35294218783580483
184782,Rowan University,1,218341576,26696186,42021692,287059454,0.7606144753553388,0.09299880435221618,0.14638672029244507
185129,New Jersey City University,1,64976513,17758,22608634,87602905,0.7417164191073344,2.0271017268205888e-4,0.25808087071998354
185262,Kean University,1,120599629,1476476,35744029,157820134,0.764158703603686,0.009355434966238212,0.22648586143007585
185572,Monmouth University,2,66320435,2866907,17114196,86301538,0.7684733845647108,0.03321965131142854,0.1983069641238607
185590,Montclair State University,1,185808000,20743000,21489000,228040000,0.8148044202771444,0.0909621119101912,0.09423346781266445
185828,New Jersey Institute of Technology,1,134435000,100817000,36101000,271353000,0.49542477879367464,0.3715344956569487,0.13304072554937665
186034,Passaic County Community College,1,33081730,221714,6093842,39397286,0.839695658223767,0.00562764653382469,0.15467669524240832
186131,Princeton University,2,533349000,384011000,141931000,1059291000,0.5034962064248634,0.3625170042981579,0.13398678927697866
186201,Ramapo College of New Jersey,1,70004000,301000,20428000,90733000,0.7715384700164218,0.0033174258538789633,0.22514410412969924
186283,Rider University,2,59197000,595000,26999000,86791000,0.6820638084594025,0.006855549538546624,0.3110806420020509
186371,Rutgers University-Camden,1,96104000,5851000,23837000,125792000,0.7639913508013229,0.04651329178326126,0.18949535741541593
186380,Rutgers University-New Brunswick,1,833279000,580008000,106980000,1520267000,0.5481135879421181,0.38151719401920847,0.07036921803867346
186399,Rutgers University-Newark,1,166439000,29716000,38985000,235140000,0.707829378242749,0.12637577613336737,0.16579484562388364
186584,Seton Hall University,2,116401000,2863000,53689000,172953000,0.6730209941429175,0.0165536301769845,0.31042537568009804
186645,Raritan Valley Community College,1,26467319,1314749,6859985,34642053,0.7640228193173193,0.03795239849093239,0.19802478219174827
186867,Stevens Institute of Technology,2,85418000,28689000,34415000,148522000,0.5751201842151331,0.1931633024063775,0.2317165133784894
186876,Stockton University,1,76126810,2046421,30055300,108228531,0.7033894786948555,0.01890833203677134,0.27770218926837326
187134,The College of New Jersey,1,101628000,16662000,30984000,149274000,0.6808151453032678,0.11162024197114032,0.20756461272559187
187444,William Paterson University of New Jersey,1,106251344,10358335,24006866,140616545,0.7556105435530364,0.07366370010015535,0.17072575634680826
187620,New Mexico State University-Dona Ana,1,32335326,153967,4466702,36955995,0.8749683508724363,0.004166225263316547,0.1208654238642472
187648,Eastern New Mexico University-Main Campus,1,23019156,437608,9223000,32679764,0.7043856253062293,0.013390794376605657,0.2822235803171651
187897,New Mexico Highlands University,1,29080596,1427862,6499745,37008203,0.785787842765562,0.03858231106222585,0.17562984617221214
187958,University of New Mexico-Gallup Campus,1,7675371,7697,1205529,8888597,0.8635075929305829,8.659409353354641e-4,0.1356264661340817
187967,New Mexico Institute of Mining and Technology,1,16516989,56143426,2336819,74997234,0.2202346422536063,0.7486066219455507,0.031158735800843003
187985,University of New Mexico-Main Campus,1,254784287,189779263,26856574,471420124,0.5404612022884284,0.40256928658395585,0.05696951112761576
187994,New Mexico State University-Alamogordo,1,7554153,13269,1110844,8678266,0.8704680174587873,0.001528992082058789,0.12800299045915395
188003,New Mexico State University-Carlsbad,1,7121891,735,2037481,9160107,0.7774899354341603,8.023923738008738e-5,0.2224298253284596
188030,New Mexico State University-Main Campus,1,119430776,93931036,17014518,230376330,0.5184160021995315,0.40772867594513723,0.07385532185533124
188049,University of New Mexico-Valencia County Campus,1,4389422,196356,1318693,5904471,0.743406479598257,0.03325547707830219,0.22333804332344084
188225,University of New Mexico-Taos Campus,1,2981673,234419,754340,3970432,0.7509694159224991,0.05904118242045198,0.18998940165704892
188304,Western New Mexico University,1,17447569,359214,3260892,21067675,0.8281677498822247,0.01705048136540933,0.15478176875236588
188429,Adelphi University,2,105179765,668720,36148814,141997299,0.7407166596880128,0.004709385352463641,0.25457395495952356
188526,Albany College of Pharmacy and Health Sciences,2,19344220,4503031,7347424,31194675,0.6201128878566614,0.14435255376117878,0.23553455838215978
188580,Albany Medical College,2,30901000,20259000,1362000,52522000,0.5883439320665625,0.38572407752941623,0.025931990404021173
188641,Alfred University,2,26965130,3602942,11676428,42244500,0.6383110227366876,0.08528783628638048,0.2764011409769319
189088,Bard College,2,87489627,1291679,13983781,102765087,0.8513555484072134,0.012569239590095418,0.13607521200269115
189097,Barnard College,2,72260000,5948000,12589000,90797000,0.795841272288732,0.06550877231626595,0.13864995539500205
190035,CUNY System Office,1,70126777,4500000,16905805,91532582,0.7661400505450616,0.049162821605971956,0.18469712784896639
190044,Clarkson University,2,56142009,12056676,20024147,88222832,0.6363659806341289,0.13666162972415122,0.22697238964171995
190099,Colgate University,2,79430866,2456249,47447918,129335033,0.6141481094298712,0.018991366399543116,0.36686052417058573
190150,Columbia University in the City of New York,2,2933539000,740973000,186705000,3861217000,0.759744660815489,0.19190141346627243,0.04835392571823858
190372,Cooper Union for the Advancement of Science and Art,2,30224432,728863,5514602,36467897,0.8287955842367329,0.01998642806301663,0.15121798770025044
190415,Cornell University,2,765283457,422514583,218956285,1406754325,0.5440064717767973,0.300347100763312,0.15564642745989068
190424,Weill Cornell Medical College,2,225997138,286323862,13790248,526111248,0.42956150217111494,0.5442268400237662,0.026211657805118815
190512,CUNY Bernard M Baruch College,1,161245848,2570597,26631935,190448380,0.8466643192239283,0.013497604967813326,0.13983807580825838
190521,CUNY Borough of Manhattan Community College,1,189042022,627954,28614577,218284553,0.8660348128252575,0.0028767679222817017,0.13108841925246081
190530,CUNY Bronx Community College,1,96570906,601475,14871939,112044320,0.8618991663298952,0.005368188231228499,0.13273264543887633
190549,CUNY Brooklyn College,1,153885870,13387436,25903604,193176910,0.7966059194134537,0.06930142945137698,0.1340926511351693
190558,College of Staten Island CUNY,1,114129844,5258031,19793408,139181283,0.8200085639388739,0.03777829092148834,0.1422131451396378
190567,CUNY City College,1,238385043,71712786,23080472,333178301,0.7154879002759547,0.21523846476424646,0.0692736349597989
190576,CUNY Graduate School and University Center,1,173759715,45463249,41245581,260468545,0.6671044098626189,0.1745441047401712,0.15835148539720986
190585,CUNY Hostos Community College,1,63910427,213244,14138870,78262541,0.8166157932439224,0.0027247262518603887,0.1806594805042172
190594,CUNY Hunter College,1,234365195,35626310,32663335,302654840,0.7743646029252332,0.11771267229693072,0.10792272477783603
190600,CUNY John Jay College of Criminal Justice,1,149507286,20423108,23698178,193628572,0.7721344244588035,0.10547569394872158,0.1223898815924749
190619,CUNY Kingsborough Community College,1,99539056,756621,20112845,120408522,0.8266778326537386,0.006283782804011165,0.16703838454225026
190628,CUNY LaGuardia Community College,1,127645313,1642748,25666050,154954111,0.8237620297792551,0.010601512856925751,0.16563645736381916
190637,CUNY Lehman College,1,128041846,6969284,18215283,153226413,0.8356382133672998,0.04548356816262481,0.11887821847007539
190646,CUNY Medgar Evers College,1,74630968,1869816,13083067,89583851,0.8330850612796273,0.02087224403871631,0.1460426946816564
190655,CUNY New York City College of Technology,1,132803876,2595646,16388696,151788218,0.8749287510576085,0.017100444515397103,0.10797080442699446
190664,CUNY Queens College,1,165578547,21437335,24822070,211837952,0.7816283410821494,0.10119685730345429,0.11717480161439628
190673,CUNY Queensborough Community College,1,110001722,1059757,18331857,129393336,0.8501343685891212,0.008190197677568187,0.14167543373331065
190682,CUNY School of Law,1,17715519,898939,4974104,23588562,0.7510215756263565,0.03810910559109114,0.21086931878255233
190691,CUNY York College,1,66666691,2334951,14552114,83553756,0.7978898159886433,0.027945494155882114,0.1741646898554746
190716,D'Youville College,2,32296345,139290,10256356,42691991,0.7564965756691928,0.003262672851214646,0.2402407514795925
191515,Hamilton College,2,59083000,1413000,21247000,81743000,0.7227897189973453,0.017285883806564477,0.2599243971960902
191533,Hartwick College,2,16394424,132102,9859906,26386432,0.6213202300333748,0.005006436641376902,0.3736733333252484
191630,Hobart William Smith Colleges,2,35186920,1432789,26202822,62822531,0.5601003245157379,0.02280692893446143,0.4170927465498007
191649,Hofstra University,2,182587858,2140872,57602373,242331103,0.7534643953648822,0.008834491212628203,0.23770111342248956
191676,Houghton College,2,11282405,23361,8052517,19358283,0.5828205425036921,0.0012067702492003036,0.4159726872471076
191931,Iona College,2,34538000,234000,22671000,57443000,0.6012568981425065,0.004073603398151211,0.3946694984593423
191968,Ithaca College,2,93033613,2273491,29618558,124925662,0.7447117870786228,0.018198750869937354,0.23708946205143985
192040,Jewish Theological Seminary of America,2,7678479,46108,1725923,9450510,0.8124936114558897,0.004878890133971606,0.1826274984101387
192165,Kehilath Yakov Rabbinical Seminary,2,377250,34295,411545,823090,0.45833383955582013,0.04166616044417986,0.5
192323,Le Moyne College,2,35228564,163291,12852421,48244276,0.7302123053934937,0.0033846709607581217,0.26640302364574814
192448,Long Island University,2,144285074,2354503,46602887,193242464,0.7466530441259536,0.012184190530710683,0.24116276534333572
192703,Manhattan College,2,48669662,791824,25860703,75322189,0.6461530479418223,0.01051249320435974,0.34333445885381797
192819,Marist College,2,82726290,611155,39062864,122400309,0.6758666761208911,0.004993083800139753,0.3191402400789691
193380,Montefiore School of Nursing,2,1545520,35314,332080,1912914,0.807940137402936,0.018460840372332473,0.17359902222473148
193405,Icahn School of Medicine at Mount Sinai,2,37882675,525456026,16204527,579543228,0.0653664354438803,0.9066727046631973,0.02796085989292243
193654,The New School,2,155790000,17272000,33341000,206403000,0.7547855409078357,0.08368095424969599,0.16153350484246837
193751,New York Chiropractic College,2,11646480,394439,3269557,15310476,0.7606869962762751,0.025762686934096626,0.21355031678962821
193821,New York Law School,2,26972672,54000,8561222,35587894,0.7579170602227825,0.0015173699236037963,0.24056556985361371
193830,New York Medical College,2,36668751,19479229,7351572,63499552,0.5774647197510937,0.30676167605087984,0.11577360419802647
193900,New York University,2,1724274000,1215049000,141388000,3080711000,0.5597000173012009,0.39440538239386946,0.04589460030492961
194073,New York College of Podiatric Medicine,2,4311953,479105,1288939,6079997,0.7092031459883944,0.0788002033553635,0.2119966506562421
194091,New York Institute of Technology,2,123969391,12514196,27499391,163982978,0.7559893868984378,0.07631399400491434,0.16769661909664796
194310,Pace University,2,139368211,3733601,47705795,190807607,0.7304122366567911,0.019567359282483952,0.2500204040607249
194578,Pratt Institute-Main,2,89959653,896953,22200098,113056704,0.7957038354841832,0.007933656017426441,0.19636250849839032
194666,Rabbinical College Bobover Yeshiva Bnei Zion,2,752191,136014,108058,996263,0.7550124816439032,0.13652419090139853,0.10846332745469821
194824,Rensselaer Polytechnic Institute,2,156816000,109111000,32903000,298830000,0.5247665896998294,0.3651273299200214,0.11010608038014925
195003,Rochester Institute of Technology,2,273264000,42940000,51738000,367942000,0.7426822705752537,0.11670317604405042,0.14061455338069587
195030,University of Rochester,2,385050000,329905000,80179000,795134000,0.4842579992806244,0.4149049091096595,0.1008370916097161
195164,St Bonaventure University,2,16926436,1343065,16658019,34927520,0.4846160277053739,0.038452916210483884,0.47693105608414227
195216,St Lawrence University,2,44123161,111616,22476749,66711526,0.6614023639633128,0.0016731141782006305,0.33692452185848665
195304,Sarah Lawrence College,2,36679579,89404,12144110,48913093,0.7498928558862552,0.00182781326055173,0.24827933085319304
195526,Skidmore College,2,61494000,3260000,20164000,84918000,0.7241574224546032,0.03838997621234603,0.2374526013330507
195580,Saint Vladimirs Orthodox Theological Seminary,2,1271429,45660,150244,1467333,0.8664897470444678,0.031117680853630363,0.10239257210190189
195809,St John's University-New York,2,196832000,6493000,52631000,255956000,0.7690071731078779,0.02536764131335073,0.20562518557877135
195827,SUNY-System Office,1,7281800,1492480,17399204,26173484,0.27821286612053636,0.057022595845474755,0.6647645380339889
196006,SUNY College of Technology at Alfred,1,40676468,4639,7824953,48506060,0.8385852819214754,9.563753477400556e-5,0.1613190805437506
196015,SUNY College of Technology at Canton,1,31875478,4215,13048278,44927971,0.7094795801038957,9.381683406090161e-5,0.2904266030620435
196024,SUNY College of Technology at Delhi,1,31969074,136324,5630250,37735648,0.8471849748015458,0.003612605247960761,0.1492024199504935
196033,SUNY College of Agriculture and Technology at Cobleskill,1,25478487,126034,8397806,34002327,0.7493159806386193,0.0037066286669144733,0.24697739069446628
196042,Farmingdale State College,1,89852787,312643,18737848,108903278,0.8250696273807295,0.0028708318587067692,0.1720595407605637
196051,SUNY Morrisville,1,33242398,64852,5758524,39065774,0.8509340682716282,0.001660072062056162,0.1474058596663156
196060,SUNY at Albany,1,227498914,39088380,28149595,294736889,0.7718711925469227,0.13262126818472322,0.09550753926835402
196079,Binghamton University,1,210278212,43564531,32782640,286625383,0.7336342992344121,0.15199118286045168,0.11437451790513613
196088,University at Buffalo,1,492438919,152284555,43279264,688002738,0.7157513942916895,0.22134294907413582,0.06290565663417462
196097,Stony Brook University,1,511671838,132311139,64174556,708157533,0.7225395680426943,0.18683856745756033,0.09062186449974542
196103,SUNY College of Environmental Science and Forestry,1,44529965,18397215,6798234,69725414,0.6386475525265436,0.26385235948545244,0.09750008798800391
196112,SUNY Polytechnic Institute,1,41263775,223971530,6670614,271905919,0.15175754596206492,0.8237096523080838,0.024532801729851273
196121,SUNY College at Brockport,1,84935602,721614,14536805,100194021,0.8477112820933697,0.007202166284952273,0.1450865516216781
196130,SUNY Buffalo State,1,93846890,3697186,13826779,111370855,0.8426521462908766,0.03319706937690296,0.12415078433222049
196149,SUNY Cortland,1,67717838,476683,11974061,80168582,0.8446929746119246,0.005946007626778281,0.14936101776129707
196158,SUNY at Fredonia,1,56617341,865637,10687188,68170166,0.8305296044020195,0.012698179435267914,0.15677221616271259
196167,SUNY College at Geneseo,1,58765235,919054,10695256,70379545,0.834976057318927,0.01305853852848864,0.1519654041525844
196176,State University of New York at New Paltz,1,85781309,845072,19207294,105833675,0.8105294368734716,0.007984906505419944,0.18148565662110855
196185,SUNY Oneonta,1,61109008,653942,11545782,73308732,0.8335842993437671,0.008920383454456695,0.15749531720177617
196194,SUNY College at Oswego,1,83613594,2207368,19665041,105486003,0.792651078077155,0.020925695705808475,0.18642322621703658
196200,SUNY College at Potsdam,1,49521980,84671,8631636,58238287,0.8503337332020084,0.0014538717459186257,0.14821239505207287
196219,SUNY at Purchase College,1,57382596,71912,10779060,68233568,0.840973111650852,0.0010539094188948173,0.15797297893025322
196228,SUNY College of Optometry,1,21946522,2352943,2362488,26661953,0.8231400752975598,0.08825096196066357,0.08860896274177664
196237,SUNY College at Old Westbury,1,49202426,224632,10411941,59838999,0.8222468093090929,0.003753939801031765,0.17399925088987533
196246,SUNY College at Plattsburgh,1,61080464,865475,15273033,77218972,0.7910033301142626,0.011208061666503408,0.197788608219234
196255,SUNY Downstate Medical Center,1,126310678,22084677,9327660,157723015,0.800838596700678,0.14002190485643456,0.059139498442887364
196264,SUNY Empire State College,1,62022814,28832,15015649,77067295,0.8047877377816361,3.741145968597964e-4,0.19483814762150403
196291,SUNY Maritime College,1,23939537,297839,9011282,33248658,0.7200151356484824,0.00895792545972833,0.27102693889178925
196307,Upstate Medical University,1,106730048,16258786,7132056,130120890,0.820237611347417,0.12495138943485554,0.05481099921772745
196413,Syracuse University,2,439321354,66904890,147370196,653596440,0.6721599554612017,0.10236422034367262,0.22547582419512566
196468,Teachers College at Columbia University,2,74898459,49113147,10443297,134454903,0.5570526424015939,0.3652759840226875,0.07767137357571854
196866,Union College,2,48974412,1042075,19461409,69477896,0.7048919846392585,0.014998655111835856,0.28010936024890565
197036,United States Military Academy,1,181921706,13443696,43913002,239278404,0.760293043412309,0.05618432660558869,0.18352262998210236
197045,Utica College,2,36062414,43402,16723867,52829683,0.6826165131447032,8.215457208024512e-4,0.31656194113449443
197133,Vassar College,2,82828182,2691514,22705385,108225081,0.7653325942070675,0.024869595616195474,0.20979781017673713
197692,Yeshiva Shaar Hatorah,2,1149982,466000,281000,1896982,0.6062166114385904,0.24565335886160228,0.14813002969980738
197708,Yeshiva University,2,90337000,1932000,25521000,117790000,0.7669326767976908,0.016402071483147974,0.2166652517191612
197869,Appalachian State University,1,147123980,6096166,15321608,168541754,0.8729230384062575,0.03617006382881242,0.0909068977649301
198039,Blue Ridge Community College,1,10655254,22398,1847730,12525382,0.850692936949947,0.0017882089344660307,0.14751885411558704
198385,Davidson College,2,41585558,1120152,32062256,74767966,0.5561948548928026,0.014981710215307984,0.4288234348918894
198419,Duke University,2,1191962000,1002719000,85658000,2280339000,0.5227126317622073,0.43972365512320755,0.03756371311458516
198464,East Carolina University,1,306151273,37430063,21126854,364708190,0.8394417273711348,0.10263016851911112,0.05792810410975416
198507,Elizabeth City State University,1,18487800,1081118,9497010,29065928,0.6360643293412135,0.03719537184568819,0.3267402988130983
198543,Fayetteville State University,1,44903392,755159,11080196,56738747,0.7914061267514421,0.013309405651837887,0.1952844675967201
198613,Guilford College,2,14157787,105439,10309955,24573181,0.5761479150786379,0.004290816073018793,0.4195612688483432
198756,Johnson C Smith University,2,12789828,891823,6690684,20372335,0.6278037348197936,0.0437761798046223,0.3284200853755841
199102,North Carolina A & T State University,1,88735232,30130409,9258291,128123932,0.6925734374121456,0.2351661280579494,0.072260434529905
199111,University of North Carolina at Asheville,1,33966145,1891429,6667355,42524929,0.7987349020618,0.04447812246788231,0.15678697547031767
199120,University of North Carolina at Chapel Hill,1,813176437,652122918,53162234,1518461589,0.5355265111022838,0.4294629002959916,0.03501058860172458
199139,University of North Carolina at Charlotte,1,247864946,31610148,31231414,310706508,0.797746231952116,0.1017363562915779,0.10051741175630605
199148,University of North Carolina at Greensboro,1,169290581,18414877,26350250,214055708,0.7908716033865353,0.08602843237424905,0.12309996423921571
199157,North Carolina Central University,1,84077693,13892784,9208869,107179346,0.7844579775659388,0.12962183964063376,0.08592018279342738
199193,North Carolina State University at Raleigh,1,504527982,354944892,39911908,899384782,0.560970112122711,0.3946529884691778,0.044376899408111174
199218,University of North Carolina Wilmington,1,132824083,16643378,17173750,166641211,0.7970662371146595,0.09987552238803642,0.10305824049730411
199281,University of North Carolina at Pembroke,1,43299468,570333,7914190,51783991,0.8361554828788689,0.011013693401885537,0.15283082371924558
199643,Shaw University,2,7231852,165229,7118794,14515875,0.4982029674408191,0.011382641418447045,0.4904143911407339
199847,Wake Forest University,2,250126000,188891000,38968000,477985000,0.5232925719426342,0.39518185717125015,0.08152557088611567
199999,Winston-Salem State University,1,46942825,2355624,6997012,56295461,0.8338651849746821,0.0418439419121197,0.12429087311319824
200004,Western Carolina University,1,80059259,3042487,13560094,96661840,0.8282405859437395,0.03147557505629936,0.1402838389999611
200059,Dickinson State University,1,12247247,104302,5108221,17459770,0.7014552310826546,0.005973847307266934,0.29257092161007847
200086,Nueta Hidatsa Sahnish College,1,969367,148144,1200404,2317915,0.41820644846769617,0.06391261111818164,0.5178809404141221
200208,Cankdeska Cikana Community College,1,1853986,136945,1865562,3856493,0.4807440335040152,0.035510242077452236,0.4837457244185326
200226,Mayville State University,1,6893812,238051,3340875,10472738,0.658262624349048,0.02273054095309173,0.3190068346978603
200253,Minot State University,1,18865661,295931,8963002,28124594,0.6707887409859143,0.01052214300409101,0.31868911600999467
200280,University of North Dakota,1,188521702,85939910,42671786,317133398,0.5944555294046955,0.27098978077357844,0.13455468982172605
200332,North Dakota State University-Main Campus,1,118385415,107384973,44525192,270295580,0.4379850199548213,0.39728719574326743,0.16472778430191126
200527,Turtle Mountain Community College,2,5616821,147482,2114879,7879182,0.7128685439681429,0.018717932902171823,0.2684135231296853
200554,United Tribes Technical College,2,3418759,671262,5227827,9317848,0.3669043538808532,0.0720404539760683,0.5610551921430785
200572,Valley City State University,1,13002990,163085,1925801,15091876,0.8615887117015804,0.010806144974952086,0.12760514332346753
200800,University of Akron Main Campus,1,179807258,28143217,17773070,225723545,0.7965817566793929,0.12468002396471312,0.07873821935589395
201195,Baldwin Wallace University,2,46362900,348249,17809946,64521095,0.718569639898393,0.005397444045238228,0.27603291605636887
201441,Bowling Green State University-Main Campus,1,154748857,9474345,19168884,183392086,0.8438142581572468,0.05166168947988301,0.10452405236287023
201645,Case Western Reserve University,2,341555120,393958540,34748312,770261972,0.44342721361817405,0.5114604567288699,0.04511232965295604
201690,Central State University,1,13245731,4059443,5977102,23282276,0.5689190781863422,0.17435765300608927,0.25672326880756846
201885,University of Cincinnati-Main Campus,1,411199003,202792763,65538737,679530503,0.6051222148007093,0.29843069899689256,0.09644708620239818
201946,University of Cincinnati-Clermont College,1,15894569,1559,2905211,18801339,0.8453955859207687,8.291962609684342e-5,0.15452149445313443
201955,University of Cincinnati-Blue Ash College,1,26395746,8678,4212322,30616746,0.8621342712252961,2.834396574998532e-4,0.13758228911720402
202134,Cleveland State University,1,135017721,11818049,23524935,170360705,0.7925402809292201,0.06937074485574593,0.1380889742150339
202480,University of Dayton,2,136655000,158958000,27524000,323137000,0.42290112243413785,0.4919213831904115,0.08517749437545066
202523,Denison University,2,48641435,566115,24762199,73969749,0.6575855083677518,0.007653331363879578,0.3347611602683686
203085,Heidelberg University,2,12029950,1237197,8193622,21460769,0.5605554022784551,0.05764923894386077,0.38179535877768406
203368,John Carroll University,2,33875506,7700918,14729492,56305916,0.6016331569847829,0.13676925174256999,0.2615975912726471
203456,Kent State University at East Liverpool,1,3785045,26630,610972,4422647,0.8558324912659772,0.006021280920679403,0.13814622781334346
203465,Kent State University at Stark,1,16320329,37308,3543364,19901001,0.8200757841276426,0.0018746795701382057,0.17804953630221917
203474,Kent State University at Trumbull,1,8748327,2387,1678865,10429579,0.8387996294001896,2.2886829851904856e-4,0.16097150230129137
203483,Kent State University at Tuscarawas,1,8416357,9774,1176113,9602244,0.8764989725318374,0.0010178870688976453,0.122483140399265
203517,Kent State University at Kent,1,233765210,21089216,35578870,290433296,0.804884333922926,0.07261294173378799,0.12250272434328605
203535,Kenyon College,2,46950146,1014840,25322595,73287581,0.6406289491257734,0.013847366581795079,0.34552368429243147
204006,Miami University-Hamilton,1,13607537,646187,4239608,18493332,0.7358077495175017,0.03494162112052063,0.2292506293619776
204015,Miami University-Middletown,1,9658850,42675,2869301,12570826,0.7683544422617893,0.0033947649899855425,0.22825079274822513
204024,Miami University-Oxford,1,224924065,16138908,29209688,270272661,0.832211679005151,0.059713431392899925,0.10807488960194905
204477,Northeast Ohio Medical University,1,21468852,13746143,2903849,38118844,0.5632083701174149,0.36061279822651493,0.07617883165607016
204501,Oberlin College,2,87067704,760953,16611953,104440610,0.833657559066344,0.007285987701527212,0.15905645323212877
204635,Ohio Northern University,2,38285539,1483253,12276461,52045253,0.7356201919126034,0.02849929464268336,0.2358805134447132
204662,Ohio State University Agricultural Technical Institute,1,5768486,619799,990122,7378407,0.7818064251538306,0.08400173641817264,0.13419183842799673
204671,Ohio State University-Lima Campus,1,7955903,11700,1620264,9587867,0.8297886276478387,0.0012202922714718508,0.16899108008068947
204680,Ohio State University-Mansfield Campus,1,7875802,444937,1804243,10124982,0.7778583705136464,0.04394447318523628,0.17819715630111738
204699,Ohio State University-Marion Campus,1,10916732,59229,2045632,13021593,0.8383561058927276,0.004548521828320083,0.15709537227895234
204705,Ohio State University-Newark Campus,1,13223267,185189,2677210,16085666,0.8220528139773634,0.011512672213882845,0.1664345138087537
204796,Ohio State University-Main Campus,1,1117937991,564026566,94607463,1776572020,0.6292669131420858,0.317480270797015,0.05325281606089913
204839,Ohio University-Southern Campus,1,6898406,10516,851846,7760768,0.8888818735465356,0.0013550205340502382,0.10976310591941416
204857,Ohio University-Main Campus,1,275827169,50494817,53990610,380312596,0.7252643533268617,0.13277187642767424,0.14196377024546408
204909,Ohio Wesleyan University,2,27167971,273667,14193355,41634993,0.6525273343987352,0.0065730045877514616,0.3408996610135133
204945,Owens Community College,1,29688333,211059,5824586,35723978,0.8310477909263072,0.005908048650125134,0.16304416042356762
206084,University of Toledo,1,235149567,43883277,24047748,303080592,0.7758648135410795,0.1447907855478915,0.07934440091102897
206279,Union Institute & University,2,6483283,74939,2736248,9294470,0.697541979262938,0.008062751291897225,0.2943952694451647
206525,Wittenberg University,2,19789023,266425,10553116,30608564,0.6465191571875113,0.008704263290496084,0.3447765795219926
206589,The College of Wooster,2,34207592,1606372,21072132,56886096,0.6013348499077876,0.028238394141162367,0.37042675595104996
206604,Wright State University-Main Campus,1,96232965,35161985,17193214,148588164,0.6476489271379651,0.2366405509930118,0.11571052186902316
206613,Wright State University-Lake Campus,1,5079527,52472,821896,5953895,0.8531435304116045,0.008813054311505326,0.13804341527689018
206695,Youngstown State University,1,80048119,5079378,13668112,98795609,0.8102396433428535,0.05141299346613674,0.13834736319100985
206914,Cameron University,1,26342503,98256,6884855,33325614,0.7904581442970563,0.0029483627818530215,0.20659349292109067
206941,University of Central Oklahoma,1,108690840,6207658,26326351,141224849,0.7696297129692806,0.04395584802501718,0.18641443900570218
207041,East Central University,1,24547883,176427,3319574,28043884,0.875338202083563,0.006291104327774284,0.11837069358866269
207209,Langston University,1,14139132,21829606,3081093,39049831,0.3620792110470337,0.559019218290599,0.07890157066236728
207263,Northeastern State University,1,55697586,5479621,10917926,72095133,0.772556810457649,0.0760054218916553,0.15143776765069564
207306,Northwestern Oklahoma State University,1,12603803,89789,4365407,17058999,0.7388360243177223,0.005263438962626119,0.25590053671965163
207315,Oklahoma State University Center for Health Sciences,1,65546844,5233935,1637353,72418132,0.9051164700022917,0.07227381949040056,0.022609710507307756
207342,University of Oklahoma-Health Sciences Center,1,226847000,70881000,5717000,303445000,0.7475720476527872,0.23358763532106314,0.018840317026149713
207388,Oklahoma State University-Main Campus,1,218991234,145584036,29457241,394032511,0.5557694552772575,0.36947214236340004,0.07475840235934238
207397,Oklahoma State University-Oklahoma City,1,37486419,26775,2997212,40510406,0.925352834034791,6.609412899984266e-4,0.07398622467521061
207500,University of Oklahoma-Norman Campus,1,283492000,154686000,30189000,468367000,0.6052774853907299,0.330266649870721,0.06445586473854904
207564,Oklahoma State University Institute of Technology,1,17136359,5579,3111676,20253614,0.8460889498535915,2.7545701226457656e-4,0.15363559313414385
207582,Oral Roberts University,2,26366669,101944,12445590,38914203,0.6775590136074482,0.0026197118825740822,0.31982127450997777
207661,Rogers State University,1,12836021,35482,3861168,16732671,0.7671232524681804,0.0021205221808281534,0.2307562253509915
207722,University of Science and Arts of Oklahoma,1,6391572,215799,1283256,7890627,0.8100208006283911,0.027348777226448545,0.16263042214516032
207786,Southern School of Beauty Inc,3,41205,8068,167,49440,0.8334344660194175,0.16318770226537216,0.003377831715210356
207847,Southeastern Oklahoma State University,1,21682710,108208,5105827,26896745,0.8061462455772994,0.004023089039212738,0.18983066538348786
207865,Southwestern Oklahoma State University,1,37053336,408725,6514099,43976160,0.8425777966971195,0.009294240333853615,0.14812796296902686
207971,University of Tulsa,2,73691473,19048012,14545852,107285337,0.686873668486496,0.17754534340512906,0.13558098810837496
208646,Eastern Oregon University,1,16596070,635039,3380421,20611530,0.8051837976123073,0.03080989135692498,0.16400631103076774
209056,Lewis & Clark College,2,51847246,2756030,15465410,70068686,0.7399488838708921,0.03933326222215727,0.22071785390695067
209074,Linn-Benton Community College,1,42211675,252728,7870952,50335355,0.8386088664716878,0.005020884426065933,0.1563702491022463
209250,Mt Hood Community College,1,38865000,953000,10808000,50626000,0.7676885394856398,0.018824319519614427,0.21348714099474578
209296,National University of Natural Medicine,2,8990075,1038676,1759803,11788554,0.7626104948919096,0.08810885542026613,0.1492806496878243
209490,Oregon Health & Science University,1,217074000,290241000,3222000,510537000,0.4251875965894734,0.5685014014655158,0.006311001945010841
209506,Oregon Institute of Technology,1,34603383,4839378,6679743,46122504,0.7502494443926981,0.10492444209013457,0.14482611351716723
209542,Oregon State University,1,325423863,220247165,33810250,579481278,0.5615778720637115,0.38007641206313486,0.058345715873153715
209551,University of Oregon,1,342563131,92292215,55164766,490020112,0.6990797369557762,0.1883437286345504,0.11257653440967337
209612,Pacific University,2,49052634,1997462,15004200,66054296,0.742610806116229,0.030239698565555827,0.22714949531821518
209807,Portland State University,1,204317264,46660544,24187870,275165678,0.7425245237162172,0.16957254385483353,0.08790293242894923
209825,University of Portland,2,59107000,1101000,32055000,92263000,0.6406360079338413,0.011933277695284133,0.3474307143708746
209922,Reed College,2,37139203,1570330,12606487,51316020,0.7237350636312013,0.030601165094253216,0.24566377127454544
209940,Rogue Community College,1,18750921,1381635,8674904,28807460,0.650905043346411,0.04796101426505495,0.3011339423885341
210146,Southern Oregon University,1,36752687,425357,6012680,43190724,0.8509393591086827,0.009848341509626003,0.1392122993816913
210401,Willamette University,2,35707000,1833000,13204000,50744000,0.7036693993378528,0.03612249724105313,0.26020810342109413
210429,Western Oregon University,1,42249770,860092,7855871,50965733,0.8289838586251669,0.016875887961819366,0.1541402534130138
210438,University of Western States,2,8840285,114190,3427483,12381958,0.7139650287943151,0.009222289398817215,0.2768126818068677
210492,Bryn Athyn College of the New Church,2,4250477,492741,4297495,9040713,0.4701484274525693,0.054502449087809775,0.47534912345962094
210669,Allegheny College,2,23584030,1070643,18566632,43221305,0.5456575177450103,0.02477118633969983,0.4295712959152899
211088,Arcadia University,2,31881000,892000,14677000,47450000,0.671886195995785,0.018798735511064278,0.30931506849315066
211158,Bloomsburg University of Pennsylvania,1,78883372,547565,17278428,96709365,0.8156745936652567,0.005661964588434636,0.17866344174630863
211273,Bryn Mawr College,2,46491000,2156000,12797000,61444000,0.7566401926957881,0.03508886140225246,0.20827094590195952
211291,Bucknell University,2,87809000,2520000,45966000,136295000,0.6442569426611394,0.01848930628416303,0.3372537510546975
211361,California University of Pennsylvania,1,60169032,114659,17642658,77926349,0.7721269220504607,0.0014713765173317692,0.22640170143220748
211440,Carnegie Mellon University,2,461536528,233679590,65750851,760966969,0.60651322173223,0.3070824352692765,0.08640434299849353
211608,Cheyney University of Pennsylvania,1,6654167,488,3664421,10319076,0.6448413598271783,4.7291055904617814e-5,0.35511134911691705
211644,Clarion University of Pennsylvania,1,36329795,83634,13487564,49900993,0.7280375162073428,0.0016759987120897573,0.27028648508056746
211802,DLP Conemaugh Memorial Medical Center,3,2164694,29653,177920,2372267,0.91250015280742,0.012499857731022688,0.07499998946155724
211981,Delaware Valley University,2,20119164,195871,10163065,30478100,0.6601187081871901,0.006426614519933985,0.33345467729287587
212009,Dickinson College,2,45926217,2985431,17778569,66690217,0.6886499859492136,0.04476565130984654,0.26658436274093994
212054,Drexel University,2,407216000,138845000,81083000,627144000,0.6493181789190361,0.22139253504777212,0.12928928603319173
212106,Duquesne University,2,117148000,13980000,17787000,148915000,0.7866769633683645,0.09387905852331867,0.11944397810831682
212115,East Stroudsburg University of Pennsylvania,1,42603884,1092286,10514898,54211068,0.7858890365340155,0.020148763717401767,0.1939621997485827
212160,Edinboro University of Pennsylvania,1,46590511,25002,12778968,59394481,0.7844249198843912,4.2094820224121497e-4,0.21515413191336752
212577,Franklin and Marshall College,2,51037585,3916924,25240450,80194959,0.6364188676747126,0.048842521385914044,0.3147386109393734
212601,Gannon University,2,35746000,577000,18047000,54370000,0.6574581570719147,0.010612470112194225,0.33192937281589113
212674,Gettysburg College,2,45244458,1665786,24554958,71465202,0.6330977417512932,0.023309050466267484,0.34359320778243935
212911,Haverford College,2,38205151,4410171,16885502,59500824,0.6420944859519929,0.07411949454683182,0.2837860195011753
213020,Indiana University of Pennsylvania-Main Campus,1,105337555,1518439,21249400,128105394,0.8222725968900263,0.01185304500136817,0.16587435810860549
213251,Juniata College,2,19897996,961280,10924603,31783879,0.6260405156966524,0.03024426313729674,0.34371522116605085
213349,Kutztown University of Pennsylvania,1,69959112,659269,18869253,89487634,0.7817740717114054,0.0073671519799037265,0.21085877630869088
213367,La Salle University,2,43186683,567699,20360773,64115155,0.6735799515730719,0.008854365243287645,0.3175656831836404
213385,Lafayette College,2,60416000,2073000,32783000,95272000,0.6341422453606516,0.02175875388361743,0.34409900075573097
213543,Lehigh University,2,160521000,43945000,40365000,244831000,0.6556400129068622,0.17949115920778005,0.16486882788535764
213598,Lincoln University,1,18567629,4351489,7798449,30717567,0.6044628794982363,0.14166125201256988,0.2538758684891938
213613,Lock Haven University,1,35081901,80959,9491457,44654317,0.785632909803547,0.0018130161972917422,0.21255407399916115
213826,Marywood University,2,26518983,190768,10916323,37626074,0.7048033499322837,0.005070101121897544,0.2901265489458188
214041,Millersville University of Pennsylvania,1,60776936,1004141,18983096,80764173,0.7525234734961008,0.012433000459250663,0.23504352604464854
214157,Moravian College,2,35716932,184220,14435100,50336252,0.7095667750550836,0.0036597877807827248,0.2867734371641337
214175,Muhlenberg College,2,46445202,572259,13842410,60859871,0.7631498594533662,0.009402895382410521,0.22744724516422324
214564,Salus University,2,24314630,1655165,3773602,29743397,0.8174799267212148,0.055648149402706085,0.12687192387607912
214777,Pennsylvania State University-Main Campus,1,1310446000,880390000,205689000,2396525000,0.5468109032870511,0.367361074889684,0.08582802182326493
215062,University of Pennsylvania,2,1429760000,836815000,106066000,2372641000,0.6026027536403527,0.3526934753298118,0.044703771029835526
215123,Philadelphia College of Osteopathic Medicine,2,63890175,890581,6120702,70901458,0.9011122874229187,0.012560827733613038,0.08632688484346825
215132,University of the Sciences,2,39965318,4111396,18915184,62991898,0.6344517194893857,0.06526864772355327,0.300279632787061
215266,University of Pittsburgh-Bradford,1,12292430,22793,5661146,17976369,0.6838105070050576,0.0012679423747921506,0.31492155062015026
215275,University of Pittsburgh-Greensburg,1,9854176,4770,3375606,13234552,0.744579491621628,3.604202091615946e-4,0.2550600881692104
215284,University of Pittsburgh-Johnstown,1,19497121,25575,5137327,24660023,0.7906367727232047,0.001037103655580532,0.20832612362121478
215293,University of Pittsburgh-Pittsburgh Campus,1,568774768,771025422,171298718,1511098908,0.3763981066949457,0.510241532118161,0.11336036118689327
215743,Saint Francis University,2,24212012,828555,16194168,41234735,0.5871751570611524,0.0200936176745164,0.39273122526433113
215770,Saint Joseph's University,2,80484871,2018611,37143078,119646560,0.6726885503436121,0.01687145037851485,0.3104399992778731
215798,Saint Vincent College,2,19255094,139723,10223907,29618724,0.6500987010784124,0.0047173875552505235,0.345183911366337
215929,University of Scranton,2,64788743,415756,20856530,86061029,0.7528232436077426,0.004830943864266368,0.24234581252799103
216010,Shippensburg University of Pennsylvania,1,57486038,879943,16857190,75223171,0.7642065235457836,0.01169776530691587,0.22409571114730062
216038,Slippery Rock University of Pennsylvania,1,67803317,231600,18093736,86128653,0.7872329896997228,0.0026890006047116514,0.21007800969556553
216278,Susquehanna University,2,28436831,866761,21853347,51156939,0.5558743653524696,0.01694317558757767,0.4271824590599527
216287,Swarthmore College,2,61143000,4092000,17661000,82896000,0.7375868558193399,0.04936305732484077,0.21305008685581933
216339,Temple University,1,533819000,216551000,84932000,835302000,0.6390730538176611,0.25924875075122533,0.10167819543111353
216348,Theological Seminary of the Reformed Episcopal Church,2,413926,1710,28447,444083,0.9320915234314306,0.0038506315260885917,0.0640578450424808
216366,Thomas Jefferson University,2,186392000,185952000,17175000,389519000,0.47851837779415124,0.47738877949471015,0.044092842711138606
216524,Ursinus College,2,21328119,330921,10734401,32393441,0.6584085648696599,0.01021567915554263,0.3313757559747975
216597,Villanova University,2,169454482,7068646,77864912,254388040,0.6661259782496064,0.027786864508252827,0.3060871572421408
216667,Washington & Jefferson College,2,21435165,260349,9976050,31671564,0.676795279197453,0.008220276081092806,0.31498444472145426
216764,West Chester University of Pennsylvania,1,122879949,2794788,24418915,150093652,0.8186885145548993,0.018620294481208305,0.16269119096389234
216852,Widener University,2,68530560,764710,19659009,88954279,0.7704020623898261,0.008596663461237206,0.22100127414893667
216931,Wilkes University,2,42032835,2259172,16934949,61226956,0.686508651516172,0.036898323019684334,0.2765930254641436
217156,Brown University,2,343219000,148996000,77492000,569707000,0.6024482760436505,0.2615309273012268,0.13602079665512273
217165,Bryant University,2,41541000,7110000,33288000,81939000,0.5069747006919781,0.08677186687657892,0.4062534324314429
217402,Providence College,2,68589868,934214,15439502,84963584,0.8072854836255495,0.010995463656523718,0.18171905271792677
217420,Rhode Island College,1,65526113,15446243,13710178,94682534,0.6920612517615974,0.16313719487059777,0.14480155336780487
217484,University of Rhode Island,1,147677905,100876828,40942300,289497033,0.5101188895431615,0.3484554814072999,0.14142562904953848
217493,Rhode Island School of Design,2,47004913,277133,7888151,55170197,0.851998280883427,0.00502323745554144,0.14297848166103158
217536,Salve Regina University,2,22666000,477000,12342000,35485000,0.6387487670846836,0.013442299563195717,0.3478089333521206
217721,Benedict College,2,9173869,1122030,8782967,19078866,0.48083932242094474,0.05881009909079502,0.4603505784882603
217819,College of Charleston,1,98862872,10917022,18995220,128775114,0.7677172159210824,0.08477586748632193,0.14750691659259568
217864,Citadel Military College of South Carolina,1,47965847,1178985,11251510,60396342,0.7941846378709492,0.01952080144191514,0.18629456068713565
217873,Claflin University,2,18115650,1811616,4038213,23965479,0.7559060263306233,0.075592730694012,0.1685012429753647
217882,Clemson University,1,317928227,208078626,55186039,581192892,0.547027039346517,0.35801990847472376,0.09495305217875927
217907,Coker College,2,6432603,529896,6372819,13335318,0.4823734237158799,0.03973628525393995,0.47789029103018016
217961,Converse College,2,10454037,59131,5366163,15879331,0.6583424074981497,0.003723771486342844,0.3379338210155075
218061,Francis Marion University,1,31716477,329235,7483429,39529141,0.8023568485841875,0.008328918657756817,0.18931423275805564
218070,Furman University,2,64653917,1628800,30520397,96803114,0.6678908800392517,0.016825905001361836,0.31528321495938655
218229,Lander University,1,16567195,15657,9210976,25793828,0.6422929935021665,6.07005675931467e-4,0.357100000821902
218335,Medical University of South Carolina,1,249749385,246235703,10428301,506413389,0.4931729500540516,0.4862345829485958,0.02059246699735263
218645,University of South Carolina-Aiken,1,23547933,1331123,7518225,32397281,0.7268490525485766,0.04108749126199819,0.23206345618942528
218654,University of South Carolina-Beaufort,1,15199251,573291,4994148,20766690,0.7319053253070181,0.027606277167906874,0.240488397525075
218663,University of South Carolina-Columbia,1,440228775,165732197,64833230,670794202,0.6562799345722431,0.24706861881909944,0.09665144660865747
218672,University of South Carolina-Lancaster,1,7529171,85531,2560399,10175101,0.7399603207869878,0.008405911646478989,0.2516337675665333
218681,University of South Carolina-Salkehatchie,1,3656772,23296,2096426,5776494,0.6330435035507698,0.004032896078486362,0.3629236003707439
218690,University of South Carolina-Sumter,1,5674866,40765,2944492,8660123,0.655286997655807,0.004707207969217066,0.34000579437497597
218706,University of South Carolina-Union,1,2978728,9399,886865,3874992,0.7687055870050828,0.0024255533946908794,0.22886885960022627
218724,Coastal Carolina University,1,92957530,1995038,41559597,136512165,0.6809468592048189,0.014614360559002195,0.30443878023617893
218733,South Carolina State University,1,22868987,8174079,12463722,43506788,0.5256418147899128,0.1878805440659053,0.2864776411441819
218742,University of South Carolina-Upstate,1,37937307,333220,12350346,50620873,0.7494399987925929,0.00658266008174138,0.2439773411256657
218751,Sherman College of Chiropractic,2,6176383,150029,1499906,7826318,0.7891811960618007,0.019169806286941062,0.19164899765125823
218964,Winthrop University,1,46759923,2072133,17461229,66293285,0.7053493125284107,0.03125705718158332,0.263393630290006
219000,Augustana University,2,24716411,1283317,5984101,31983829,0.7727783624656073,0.04012393262857927,0.18709770490581348
219046,Black Hills State University,1,18073797,1597907,8788070,28459774,0.6350646705767937,0.056146159136752104,0.30878917028645414
219082,Dakota State University,1,19671379,3139207,6565275,29375861,0.66964433825446,0.10686348903952125,0.22349217270601873
219091,Dakota Wesleyan University,2,4957335,148838,5175055,10281228,0.48217343297901766,0.014476675354344831,0.5033498916666375
219259,Northern State University,1,18436828,171901,7946513,26555242,0.6942820554977431,0.006473335848342109,0.2992446086539147
219277,Oglala Lakota College,1,6988955,70431,1361970,8421356,0.8299085087959707,0.008363379959236968,0.16172811124479242
219347,South Dakota School of Mines and Technology,1,25054450,10579133,7502294,43135877,0.5808262574561773,0.24525137161347155,0.1739223709303511
219356,South Dakota State University,1,92010341,65103612,31218141,188332094,0.48855369812858346,0.34568517036719193,0.16576113150422467
219471,University of South Dakota,1,78980208,17183828,22319536,118483572,0.6665920571672164,0.1450313128642003,0.18837662996858331
219602,Austin Peay State University,1,74325930,2592164,26128430,103046524,0.7212851740637074,0.0251552784060916,0.25355954753020105
219842,Pentecostal Theological Seminary,2,1825264,484158,379453,2688875,0.6788206963878946,0.18005969039096276,0.14111961322114266
219976,Lipscomb University,2,53715162,1166311,24451070,79332543,0.6770886192315807,0.014701545619179256,0.30820983514924005
220075,East Tennessee State University,1,166973319,14558204,29298869,210830392,0.7919793603571159,0.06905173330038679,0.13896890634249734
220181,Fisk University,2,5870927,3959955,4045339,13876221,0.4230926417214024,0.28537704898185173,0.29153030929674584
220792,Meharry Medical College,2,22740496,14336059,4068351,41144906,0.5526928655518134,0.3484285272154954,0.0988786072326912
220862,University of Memphis,1,167216606,62667692,70470163,300354461,0.556730888708192,0.20864578402249867,0.23462332726930932
220978,Middle Tennessee State University,1,187881760,9105504,49344293,246331557,0.7627190047761522,0.03696442352288627,0.20031657170096157
221430,Tennessee College of Applied Technology-Crump,1,1534701,1514,281943,1818158,0.8440966076655604,8.327109085129015e-4,0.15507068142592667
221519,The University of the South,2,36349239,307794,17071949,53728982,0.6765294566720061,0.005728640084787015,0.3177419032432068
221661,Southern Adventist University,2,27287503,109473,10324349,37721325,0.7233972560613924,0.002902151501836163,0.27370059243677153
221670,Southern College of Optometry,2,15634457,184686,1190686,17009829,0.9191425146014107,0.01085760474135278,0.06999988065723647
221740,The University of Tennessee-Chattanooga,1,92542160,9405207,35060746,137008113,0.6754502195063441,0.06864708077542823,0.25590269971822766
221759,The University of Tennessee-Knoxville,1,348607315,299140908,64381655,712129878,0.4895277192680855,0.42006509941715997,0.0904071813147545
221768,The University of Tennessee-Martin,1,56968579,570192,19145285,76684056,0.742899919117476,0.007435600433028738,0.24966448044949527
221838,Tennessee State University,1,69350131,13600223,18061424,101011778,0.6865548985782628,0.13463997238025055,0.17880512904148663
221847,Tennessee Technological University,1,79592386,11500556,23656053,114748995,0.6936216391263383,0.10022358801486671,0.20615477285879497
221999,Vanderbilt University,2,351265951,227134397,131650913,710051261,0.49470505904784245,0.3198845061976448,0.18541043475451274
222178,Abilene Christian University,2,45788542,1099800,31069918,77958260,0.5873468956336378,0.014107549347561118,0.39854555501880107
222628,Amberton University,2,2878588,18263,368680,3265531,0.8815068667239723,0.005592658590593689,0.112900474685434
222831,Angelo State University,1,52722357,976219,9566570,63265146,0.8333554940345826,0.015430597441441138,0.15121390852397623
222983,Austin College,2,16558759,354238,8802866,25715863,0.6439122420274209,0.013775077274287858,0.3423126806982912
223223,Baylor College of Medicine,2,136064467,618064390,2160205,756289062,0.17991066357640909,0.8172330145375023,0.002856321886088576
223232,Baylor University,2,312249000,34033000,169832000,516114000,0.6050000581266929,0.06594085802749006,0.329059083845817
224147,Texas A & M University-Corpus Christi,1,77575739,28997980,15103854,121677573,0.6375516628688838,0.2383181985393479,0.12413013859176826
224323,University of Dallas,2,23856000,81000,8481000,32418000,0.7358874699241162,0.002498611882287618,0.26161391819359614
224545,Texas A&M University-Texarkana,1,19320471,6666,5775267,25102404,0.7696661642446676,2.655522554732208e-4,0.23006828349985922
224554,Texas A & M University-Commerce,1,65680873,3037786,15982673,84701332,0.7754408513906251,0.03586467801946727,0.1886944705899076
224642,El Paso Community College,1,75010859,202118,14647666,89860643,0.8347465196749149,0.0022492383011325657,0.16300424202395258
224712,Episcopal Theological Seminary of the Southwest,2,2476230,1281,580803,3058314,0.8096716033736235,4.188582336542291e-4,0.18990953839272226
225414,University of Houston-Clear Lake,1,51883561,1672665,9676316,63232542,0.820519931019063,0.026452597777897338,0.15302747120303972
225432,University of Houston-Downtown,1,58480498,2241778,9733039,70455315,0.8300367119215917,0.03181843697668515,0.13814485110172312
225502,University of Houston-Victoria,1,23634666,401126,9247293,33283085,0.7101104359767131,0.012051947708573289,0.2778376163147136
225511,University of Houston,1,315099552,206303658,40703917,562107127,0.5605685052984571,0.36701839932372893,0.07241309537781399
225627,University of the Incarnate Word,2,72507027,902991,25106752,98516770,0.7359866447103371,0.009165860797100838,0.25484749449256205
225885,Jarvis Christian College,2,4064638,143262,2410619,6618519,0.6141310465377526,0.021645627972058403,0.364223325490189
226091,Lamar University,1,77028730,4911025,11939267,93879022,0.8205105715737004,0.05231227270348002,0.1271771557228195
226134,Laredo College,1,38628295,862,10025149,48654306,0.7939337373345743,1.7716828598891125e-5,0.20604854583682686
226152,Texas A & M International University,1,39811899,6009863,8626212,54447974,0.7311915591202715,0.11037808312206437,0.15843035775766423
226231,LeTourneau University,2,20867880,546593,9454425,30868898,0.6760163579535622,0.01770691652160696,0.3062767255248309
226587,McMurry University,2,9709013,78592,3210143,12997748,0.7469765531690566,0.006046585916267957,0.24697686091467538
226833,Midwestern State University,1,49252202,1375279,17567129,68194610,0.7222301293313357,0.020166975073249924,0.2576028955954144
226879,Wade College,3,976146,55117,857924,1889187,0.5167016287958789,0.02917498373639031,0.45412338746773084
227216,University of North Texas,1,220991480,83142008,99751703,403885191,0.5471641073366317,0.20585554967773007,0.2469803429856382
227368,The University of Texas Rio Grande Valley,1,185132132,51641592,35064189,271837913,0.681038674689943,0.1899719999689668,0.1289893253410903
227526,Prairie View A & M University,1,69295541,25063034,23320323,117678898,0.5888527355176286,0.21297815008430823,0.19816911439806312
227757,Rice University,2,331206848,135290402,81450305,547947555,0.6044499057943602,0.24690392495683278,0.14864616924880703
227881,Sam Houston State University,1,123113654,10751928,34570526,168436108,0.7309219825953234,0.06383386631089813,0.20524415109377853
228149,St. Mary's University,2,41217342,864687,16230122,58312151,0.7068396773770187,0.014828590356750859,0.2783317322662304
228246,Southern Methodist University,2,208133000,33188000,52218000,293539000,0.7090471794207924,0.11306163746554972,0.1778911831136578
228343,Southwestern University,2,18024064,78601,11483380,29586045,0.6092082939777859,0.002656691693668417,0.38813501432854575
228431,Stephen F Austin State University,1,81587075,4218369,29516663,115322107,0.7074712483357593,0.0365790142908159,0.25594973737342486
228459,Texas State University,1,239242989,64744597,69924803,373912389,0.6398370207519387,0.17315445784814582,0.18700852139991542
228501,Sul Ross State University,1,12858119,1662548,3422691,17943358,0.7165949093809532,0.09265534355386544,0.19074974706518144
228529,Tarleton State University,1,76873388,13446224,14819687,105139299,0.7311575094294666,0.12788961052517575,0.14095288004535772
228635,University of Texas Southwestern Medical Center,1,1056794186,413105997,7037956,1476938139,0.7155304329235688,0.27970433296529557,0.004765234111135646
228644,The University of Texas Health Science Center at San Antonio,1,478460894,146827038,2555451,627843383,0.7620704573070256,0.23385933813369503,0.004070204559279396
228653,The University of Texas Medical Branch,1,423706851,121590213,7868888,553165952,0.7659669751329886,0.2198078398722559,0.014225184994755426
228705,Texas A & M University-Kingsville,1,52204323,20964674,16369398,89538395,0.5830384049211514,0.23414172210703577,0.18281987297181282
228723,Texas A & M University-College Station,1,940505024,800770999,104736748,1846012771,0.5094791535437324,0.43378410571136833,0.05673674074489921
228769,The University of Texas at Arlington,1,235312417,111074645,100466173,446853235,0.5265988887828014,0.2485707527662858,0.22483035845091287
228778,The University of Texas at Austin,1,886584411,635211650,64828865,1586624926,0.5587863876783693,0.4003540090608661,0.040859603260764606
228787,The University of Texas at Dallas,1,261507079,122525598,23087544,407120221,0.6423338009536009,0.3009567977219191,0.056709401324480026
228796,The University of Texas at El Paso,1,138230081,99606628,21771850,259608559,0.5324557924147639,0.38368006195049986,0.08386414563473618
228802,The University of Texas at Tyler,1,71496104,2453763,13868508,87818375,0.8141360392970151,0.027941339155956826,0.15792262154702816
228866,Texas Chiropractic College Foundation Inc,2,4054570,341119,1155109,5550798,0.7304481265576589,0.06145404678750695,0.20809782665483414
228875,Texas Christian University,2,195608000,6595000,104493957,306696957,0.637789177673517,0.02150331083982682,0.3407075114866562
228909,University of North Texas Health Science Center,1,84729795,43590358,7410958,135731111,0.6242474136972179,0.32115229646945126,0.054600289833330845
228981,Texas Lutheran University,2,12551591,62350,7589379,20203320,0.6212637823882411,0.0030861264386249387,0.3756500911731339
229018,The University of Texas of the Permian Basin,1,33572643,2163721,5364439,41100803,0.8168366686169124,0.05264425125708615,0.13051908012600144
229027,The University of Texas at San Antonio,1,180183610,79399933,37687573,297271116,0.6061255207855445,0.26709602355043466,0.12677845566402085
229063,Texas Southern University,1,96445982,4932179,14556658,115934819,0.8318983272833678,0.042542689440003355,0.12555898327662893
229115,Texas Tech University,1,262464380,197405657,57443237,517313274,0.5073606133679067,0.3815978961328566,0.11104149049923664
229160,Texas Wesleyan University,2,23986725,47510,12180794,36215029,0.6623417311083749,0.0013118862889768775,0.3363463826026482
229179,Texas Woman's University,1,90329841,5520272,17050384,112900497,0.8000836435644743,0.04889501947896651,0.1510213369565592
229267,Trinity University,2,50031153,3250229,24829414,78110796,0.6405152112391737,0.04161049645429295,0.3178742923065334
229300,The University of Texas Health Science Center at Houston,1,809015812,217114742,9942463,1036073017,0.7808482594620066,0.20955544487459613,0.009596295663397245
229337,Texas Tech University Health Sciences Center,1,216426453,44037634,17324569,277788656,0.7791047198126045,0.15852927413997783,0.06236600604741757
229814,West Texas A & M University,1,42224640,4464816,13694779,60384235,0.6992659590702772,0.07394009380097305,0.22679394712874976
229887,Wiley College,2,5551702,38222,4139986,9729910,0.570581022846049,0.003928299439563162,0.4254906777143879
230038,Brigham Young University-Provo,2,539007459,44877151,59650931,643535541,0.8375721691492405,0.06973531085830115,0.09269251999245835
230047,Brigham Young University-Hawaii,2,46427000,89000,7035000,53551000,0.8669679371066833,0.0016619670967862412,0.13137009579653042
230171,Dixie State University,1,28372446,60419,14413857,42846722,0.6621847524298359,0.0014101195419336863,0.33640512802823047
230597,Snow College,1,24432172,36039,6719525,31187736,0.7833903685730828,0.0011555503740316385,0.21545408105288566
230603,Southern Utah University,1,57756129,76480,24849248,82681857,0.6985344922768244,9.249913194378303e-4,0.30054051640373775
230728,Utah State University,1,242308620,231394223,32083813,505786656,0.47907278123209324,0.45749372834383356,0.06343349042407319
230737,Utah Valley University,1,154993751,419087,36738634,192151472,0.8066227616512873,0.0021810241453679834,0.19119621420334473
230764,University of Utah,1,475062000,384922000,82255000,942239000,0.5041841825693906,0.4085184332212952,0.0872973842093142
230782,Weber State University,1,111329601,1021463,27532533,139883597,0.7958731644568734,0.007302235729611671,0.19682459981351494
230834,Castleton University,1,15615314,27129,11310528,26952971,0.5793540905008209,0.0010065309683299848,0.41963937853084915
230959,Middlebury College,2,98735000,10041000,41701000,150477000,0.6561467865520977,0.06672780557826113,0.2771254078696412
230995,Norwich University,2,29828000,1237000,25787000,56852000,0.5246605220572715,0.02175824948990361,0.4535812284528249
231059,Saint Michael's College,2,20413020,963375,14948288,36324683,0.5619600314199577,0.02652122249766089,0.4115187460823815
231165,Vermont Technical College,1,21164443,24765,2561540,23750748,0.891106376944423,0.0010427040024171027,0.10785091905315992
231174,University of Vermont,1,210368000,109579000,51540000,371487000,0.5662863034238076,0.2949739829388377,0.13873971363735474
231624,College of William and Mary,1,139595385,62601098,21315342,223511825,0.6245548082299449,0.28007957968219355,0.09536561208786157
231651,Regent University,2,28178600,18200,41700400,69897200,0.40314347355831137,2.6038239013866077e-4,0.59659614405155
231712,Christopher Newport University,1,46934288,2431509,9763933,59129730,0.7937510961068146,0.04112159822140233,0.16512730567178305
231970,Eastern Virginia Medical School,1,99144267,25617540,2593248,127355055,0.7784870965663672,0.20115055503686133,0.02036234839677153
232025,Emory & Henry College,2,17443856,400174,7308788,25152818,0.693514977129004,0.015909708407224988,0.290575314463771
232043,Eastern Mennonite University,2,14897590,323974,6046891,21268455,0.7004547344882363,0.015232606223630254,0.28431265928813354
232186,George Mason University,1,388256105,129943237,39089738,557289080,0.6966870856324693,0.23317025519322934,0.07014265917430143
232256,Hampden-Sydney College,2,15923976,76250,13491760,29491986,0.5399424779328188,0.002585448128179635,0.4574720739390016
232265,Hampton University,2,49866550,16178143,16846130,82890823,0.6015931341398312,0.1951741147509176,0.20323275110925126
232308,Hollins University,2,14776717,398975,5304748,20480440,0.7215038837056235,0.019480782639435482,0.259015333654941
232423,James Madison University,1,207699270,3487295,23330031,234516596,0.8856484937211011,0.014870141642342447,0.09948136463655646
232557,Liberty University,2,234922006,1480710,201027485,437430201,0.5370502664492524,0.0033850200480327604,0.45956471350271494
232566,Longwood University,1,40632612,230000,5292997,46155609,0.8803396354276248,0.004983143002186365,0.1146772215701888
232609,University of Lynchburg,2,33251199,73893,12481690,45806782,0.725901221351895,0.0016131454071582675,0.2724856332409467
232681,University of Mary Washington,1,35578105,393565,10020258,45991928,0.7735728104288213,0.008557262483103557,0.2178699270880751
232706,Marymount University,2,37389090,1695778,13307832,52392700,0.7136316700609054,0.032366684671719534,0.254001645267375
232937,Norfolk State University,1,52342147,8749166,7381677,68472990,0.7644203502724213,0.1277754337878337,0.107804215939745
232982,Old Dominion University,1,207818832,16347853,22004954,246171639,0.8442029831064333,0.06640835258849619,0.08938866430507049
233277,Radford University,1,89695997,612875,7583118,97891990,0.9162751416127101,0.006260726745875735,0.07746413164141418
233356,Bon Secours Memorial College of Nursing,2,3039047,51881,1037136,4128064,0.7361918322971737,0.01256787685462241,0.25124029084820393
233374,University of Richmond,2,91168000,4829000,53654000,149651000,0.6092040814962814,0.03226841116998884,0.3585275073337298
233426,Roanoke College,2,24574959,370688,12513905,37459552,0.6560398533330031,0.009895686953223574,0.3340644597137734
233718,Sweet Briar College,2,7935092,85695,2868229,10889016,0.7287244320331607,0.007869857111055764,0.26340571085578346
233897,The University of Virginia's College at Wise,1,16936246,96662,2914988,19947896,0.8490241777879732,0.004845724080374191,0.1461300981316526
233921,Virginia Polytechnic Institute and State University,1,462466221,386907271,28363079,877736571,0.5268849860876994,0.44080112847434266,0.0323138854379579
234030,Virginia Commonwealth University,1,432957192,204706783,26078012,663741987,0.6522974295432059,0.3084131891749678,0.039289381281826304
234076,University of Virginia-Main Campus,1,544400133,512761397,68661968,1125823498,0.4835572662740781,0.4554545165480282,0.060988217177893725
234085,Virginia Military Institute,1,28764113,224838,8093762,37082713,0.7756744497092216,0.006063148615906285,0.21826240167487207
234137,Virginia University of Lynchburg,2,2618083,13627,362619,2994329,0.874347140878641,0.004550936119578042,0.12110192300178103
234155,Virginia State University,1,42537969,9719435,6692797,58950201,0.7215915854129149,0.16487534961924896,0.11353306496783616
234207,Washington and Lee University,2,78470000,1670000,15528000,95668000,0.8202324706275871,0.017456202701007652,0.16231132667140527
234827,Central Washington University,1,114466826,3413260,17323981,135204067,0.8466226537401423,0.025245246505787432,0.12813209975407028
235097,Eastern Washington University,1,93289678,1100524,25984911,120375113,0.7749914054078604,0.00914245455370829,0.21586614003843135
235167,The Evergreen State College,1,31923869,14702,7256708,39195279,0.8144825043852858,3.7509619462078585e-4,0.18514239942009342
235547,Bastyr University,2,23452104,947535,3805805,28205444,0.8314743777832393,0.03359404659611102,0.1349315756206497
236230,Pacific Lutheran University,2,34756000,341000,10900000,45997000,0.7556144965976042,0.007413526969150162,0.23697197643324563
236328,University of Puget Sound,2,49527000,1285000,18454000,69266000,0.7150261311465943,0.018551670372188377,0.26642219848121734
236452,Saint Martin's University,2,13020088,100853,8807120,21928061,0.5937637623317447,0.004599266665666426,0.4016369710025889
236577,Seattle Pacific University,2,45341000,712000,18901000,64954000,0.6980478492471596,0.010961603596391293,0.2909905471564492
236595,Seattle University,2,109998661,1359000,42039206,153396867,0.7170854473840069,0.00885937259722521,0.27405518001876794
236896,Walla Walla University,2,20712264,59522,6766858,27538644,0.752116335139813,0.0021613990870429207,0.2457222657731441
236939,Washington State University,1,292221605,233370129,33776935,559368669,0.5224132512148263,0.41720271787335306,0.0603840309118207
236948,University of Washington-Seattle Campus,1,1593366210,850021928,61683919,2505072057,0.636056039005987,0.33932035033673286,0.024623610657280186
237011,Western Washington University,1,155593179,8427275,27254599,191275053,0.8134525467887336,0.044058411527403946,0.14248904168386245
237057,Whitman College,2,32979049,679466,14746293,48404808,0.6813176286124304,0.014037159283846348,0.30464521210372325
237066,Whitworth University,2,28807523,1407078,15239065,45453666,0.6337777683322617,0.03095631494278151,0.3352659167249568
237215,Bluefield State College,1,7960574,74290,2080064,10114928,0.7870124236178448,0.007344590094956682,0.2056429862871985
237312,University of Charleston,2,15651822,96312,9095148,24843282,0.6300223134769392,0.0038767824637662607,0.3661009040592946
237330,Concord University,1,11048619,205185,2672972,13926776,0.7933364477176914,0.014733129907453096,0.19193042237485547
237367,Fairmont State University,1,22409306,138208,5580469,28127983,0.7966908256450524,0.004913541081136176,0.19839563327381135
237525,Marshall University,1,108976641,16803790,17804119,143584550,0.7589719158502778,0.11703062759886074,0.1239974565508615
237792,Shepherd University,1,22881137,478176,4314626,27673939,0.8268117162504406,0.017278928019607183,0.1559093557299523
237880,West Virginia School of Osteopathic Medicine,1,17450339,1737012,4054529,23241880,0.7508144349768607,0.07473629499851131,0.17444927002462796
237899,West Virginia State University,1,16474932,5904608,1995046,24374586,0.6759061261594351,0.2422444426338154,0.08184943120674952
237932,West Liberty University,1,12949253,604405,2340319,15893977,0.8147270503788951,0.03802729801358087,0.14724565160752404
238032,West Virginia University,1,346206816,134324969,42307404,522839189,0.6621669210798198,0.2569145003397976,0.08091857858038258
238078,Wheeling Jesuit University,2,7626783,935373,7237470,15799626,0.4827192112015816,0.05920222415391352,0.45807856464450486
238193,Alverno College,2,13975325,216216,6738227,20929768,0.6677247927449554,0.010330549292280736,0.32194465796276384
238333,Beloit College,2,18134283,92775,7643992,25871050,0.7009488598259445,0.0035860546827438393,0.29546508549131173
238616,Concordia University-Wisconsin,2,58357288,322034,19052094,77731416,0.7507554989092183,0.004142906646651079,0.24510159444413054
239017,Lawrence University,2,27821747,712949,13973046,42507742,0.6545101125343238,0.01677221528257135,0.3287176721831049
239105,Marquette University,2,124496000,42500000,66564000,233560000,0.533036478849118,0.18196609008391848,0.2849974310669635
239318,Milwaukee School of Engineering,2,30764257,6862442,9392046,47018745,0.6542977061595328,0.14595119457144168,0.19975109926902557
239512,Northland College,2,5296794,1029931,4012259,10338984,0.5123128152630858,0.09961626790408032,0.38807091683283385
239716,Saint Norbert College,2,24219110,409502,11069403,35698015,0.6784441655929608,0.011471282086693055,0.3100845523203461
240189,University of Wisconsin-Whitewater,1,76502593,1036960,27741838,105281391,0.7266487673970797,0.009849413938689317,0.263501818664231
240268,University of Wisconsin-Eau Claire,1,67488838,1231273,26516136,95236247,0.7086465513492988,0.012928617399213558,0.2784248312514877
240277,University of Wisconsin-Green Bay,1,29811752,1986042,19209057,51006851,0.5844656436446155,0.03893676949396464,0.37659758686141986
240329,University of Wisconsin-La Crosse,1,74157945,2603577,26188015,102949537,0.720332962740765,0.025289836903297582,0.25437720035593747
240338,Wisconsin Lutheran College,2,9945136,50800,5787927,15783863,0.6300825089523395,0.0032184769976779447,0.36669901404998256
240365,University of Wisconsin-Oshkosh,1,80216287,2176394,26140468,108533149,0.7390948087206057,0.020052804328012264,0.240852386951382
240374,University of Wisconsin-Parkside,1,25324377,405438,14557600,40287415,0.6285927503663364,0.010063638980063625,0.3613436106535999
240417,University of Wisconsin-Stout,1,61514460,596712,21444429,83555601,0.7362098921411624,0.00714149611586182,0.2566486117429758
240426,University of Wisconsin-Superior,1,19267384,2264802,12274321,33806507,0.5699312265535152,0.06699307917259834,0.36307569427388636
240444,University of Wisconsin-Madison,1,672748015,1047622014,160666312,1881036341,0.3576475373369727,0.5569387423121561,0.0854137203508712
240453,University of Wisconsin-Milwaukee,1,202496145,51633807,63326505,317456457,0.6378706135437024,0.16264846992858614,0.19948091652771138
240462,University of Wisconsin-Platteville,1,39328353,979202,20475118,60782673,0.6470323047490854,0.016109887105491397,0.33685780814542327
240471,University of Wisconsin-River Falls,1,40161645,1010834,16563949,57736428,0.6956032160493199,0.017507733592386422,0.2868890503582937
240480,University of Wisconsin-Stevens Point,1,53223480,3600725,24295212,81119417,0.6561127035713287,0.04438795461264225,0.29949934181602905
240514,Central Wyoming College,1,7831885,216158,2850022,10898065,0.7186491363375058,0.019834530258353203,0.261516333404141
240596,Eastern Wyoming College,1,6771021,54220,2367806,9193047,0.7365371894650381,0.005897935689875185,0.2575648748450867
240693,Western Wyoming Community College,1,14273601,60475,5587583,19921659,0.7164865636943188,0.003035640756625741,0.28047779554905544
240727,University of Wyoming,1,176673386,93793915,22915140,293382441,0.602194819150748,0.31969846143587033,0.07810671941338167
240736,American Samoa Community College,1,3720760,2567646,831383,7119789,0.5225941386746152,0.36063512556341204,0.11677073576197272
240745,Guam Community College,1,11700832,752978,2999040,15452850,0.757195727648945,0.048727451570422284,0.1940768207806327
240754,University of Guam,1,19789878,14335457,2597485,36722820,0.5388986466725595,0.3903691764412428,0.07073217688619773
241100,American University of Puerto Rico,2,3215073,91091,1822675,5128839,0.6268617517531746,0.017760549707253433,0.355377698539572
241216,Atlantic University College,2,2477184,49640,71677,2598501,0.9533126983595542,0.019103321491890903,0.027583980148554878
241331,Carlos Albizu University-San Juan,2,5500647,303550,1097237,6901434,0.7970295738537817,0.04398361268107469,0.15898681346514362
241410,Pontifical Catholic University of Puerto Rico-Ponce,2,39390372,237563,9040289,48668224,0.8093653057896668,0.004881275306039522,0.1857534189042937
241739,Universidad Ana G. Mendez-Cupey Campus,2,37464281,2029431,9168244,48661956,0.7698885141402865,0.041704673770203565,0.18840681208950993
241951,Escuela de Artes Plasticas y Diseno de Puerto Rico,1,1191028,45948,215152,1452128,0.8201949139469799,0.0316418387359792,0.14816324731704092
243106,University of Puerto Rico-Aguadilla,1,13796259,33411,2200390,16030060,0.8606492427352113,0.0020842716745913615,0.1372664855901974
243115,University of Puerto Rico-Arecibo,1,18659005,532399,3192610,22384014,0.8335861923603157,0.023784786767913922,0.14262902087177037
243133,University of Puerto Rico-Bayamon,1,22002310,139465,4075821,26217596,0.8392192022487492,0.005319518997851672,0.15546127875339905
243142,University of Puerto Rico-Carolina,1,13924347,1095,3110918,17036360,0.8173311082883903,6.427429333496122e-5,0.1826046174182748
243151,University of Puerto Rico-Cayey,1,16795200,2466766,2868372,22130338,0.7589219830261968,0.11146535583866816,0.12961266113513495
243179,University of Puerto Rico-Humacao,1,24119908,2390480,3789732,30300120,0.7960334150491813,0.07889341692376135,0.1250731680270573
243188,University of Puerto Rico-Utuado,1,5961058,135063,1912204,8008325,0.7443576528175367,0.01686532452166964,0.23877702266079362
243197,University of Puerto Rico-Mayaguez,1,65499016,41128090,8674339,115301445,0.5680676074788135,0.3567005599973183,0.0752318325238682
243203,University of Puerto Rico-Medical Sciences,1,80493021,37794048,3000235,121287304,0.6636557854398346,0.31160761888152777,0.02473659567863756
243212,University of Puerto Rico-Ponce,1,12515861,815234,2663540,15994635,0.7825036957704881,0.05096921561511094,0.16652708861440102
243221,University of Puerto Rico-Rio Piedras,1,121052349,19575517,13109407,153737273,0.7873975298104839,0.12733097587856915,0.08527149431094697
243346,Universidad Ana G. Mendez-Carolina Campus,2,28494463,957137,6963662,36415262,0.7824868320321299,0.026283952041866402,0.19122921592600378
243568,Universidad Central Del Caribe,2,4528421,3850551,467708,8846680,0.5118780152554404,0.4352537901223962,0.05286819462216334
243577,Universidad Politecnica de Puerto Rico,2,14869395,2021530,6241900,23132825,0.6427833608735639,0.08738794332296207,0.2698286958034741
243601,Universidad Ana G. Mendez-Gurabo Campus,2,44016127,981126,7816707,52813960,0.833418418160653,0.01857702016663776,0.14800456167270926
243647,Palau Community College,1,2945230,1080321,1072132,5097683,0.5777585620761432,0.2119239270076229,0.2103175109162339
243665,University of the Virgin Islands,1,15652007,13890382,5256852,34799241,0.4497801259515976,0.3991576138111748,0.15106226023722757
243744,Stanford University,2,2067888000,890980000,237319000,3196187000,0.6469859241652631,0.27876341403053073,0.07425066180420607
243780,Purdue University-Main Campus,1,820653028,337341720,66707543,1224702291,0.6700836881181274,0.27544793741224416,0.05446837446962855
243823,Parker University,2,14881000,330000,4942000,20153000,0.7384012305860169,0.016374733290328982,0.24522403612365404
243832,EDP University of Puerto Rico Inc-San Juan,2,9120566,663582,5873076,15657224,0.5825148825871048,0.04238184240067077,0.3751032750122244
246789,Unification Theological Seminary,2,267967,1463,278382,547812,0.489158689477412,0.0026706242287500093,0.508170686293838
247825,Austin Graduate School of Theology,2,315075,20214,70324,405613,0.7767872331508112,0.049835680809047045,0.1733770860401417
248934,ECPI University,3,109811203,2577062,55792298,168180563,0.6529363503201021,0.015323185712013581,0.3317404639678843
260372,Lac Courte Oreilles Ojibwa Community College,1,2295155,127927,828264,3251346,0.7059091834581739,0.039345858607481334,0.2547449579343447
262031,St Charles Community College,1,31027312,246829,6632322,37906463,0.8185230049028842,0.0065115281264833385,0.17496546697063242
262129,New College of Florida,1,16326638,943129,6276356,23546123,0.6933896506019271,0.0400545346679791,0.26655581473009377
262402,California Career School,3,466721,30324,122005,619050,0.753931023342218,0.048984734674097405,0.19708424198368468
363165,Metro Technology Centers,1,23546795,739027,3009391,27295213,0.8626712310323426,0.02707533368580051,0.11025343528185694
366289,InterCoast Colleges-Anaheim,3,3494111,108063,3808543,7410717,0.4714943236936453,0.014581989839849504,0.5139236864665052
366368,New York Academy of Art,2,1527891,820344,97810,2446045,0.6246373226984786,0.3353756778800063,0.03998699942151514
366711,California State University-San Marcos,1,100953447,1562617,28975106,131491170,0.7677583749539988,0.011883816989384155,0.22035780805661703
369659,Oregon College of Oriental Medicine,2,3798472,72083,1070430,4940985,0.7687681707189963,0.014588791506147053,0.21664303777485663
371830,CRU Institute of Cosmetology and Barbering,3,11000,1300,5300,17600,0.625,0.07386363636363637,0.30113636363636365
373456,Blalock's Professional Beauty College,3,194503,33757,33756,262016,0.7423325293111871,0.1288356436248168,0.1288318270639961
380359,Bay Mills Community College,1,1539624,73526,1002949,2616099,0.5885190124685649,0.02810520549872157,0.3833757820327136
380368,Fond du Lac Tribal and Community College,1,5144000,28000,4291000,9463000,0.5435908274331608,0.0029588925287963646,0.4534502800380429
383190,Hawaii Community College,1,18884506,156355,3861610,22902471,0.8245619435562215,0.006826992598309588,0.1686110638454689
395362,Copper Mountain Community College,1,9128130,480672,3173897,12782699,0.7141003633113789,0.03760332618330448,0.2482963105053166
399869,Southern California Institute of Technology,3,1083306,434253,376532,1894091,0.5719397853640612,0.22926723161664356,0.19879298301929527
407629,Lake Erie College of Osteopathic Medicine,2,50461152,481398,7270076,58212626,0.8668420490084059,0.008269649268184534,0.12488830172340963
409254,Erikson Institute,2,7259749,1907990,1106007,10273746,0.7066311547900834,0.18571512279941513,0.10765372241050149
409698,California State University-Monterey Bay,1,61393860,1177785,30173330,92744975,0.6619642735361134,0.012699178580834164,0.32533654788305244
413617,College of Menominee Nation,2,4322753,614498,839130,5776381,0.7483497020019975,0.10638114071769159,0.14526915728031098
418126,New York College of Health Professions,2,3868255,157397,1920974,5946626,0.6504957601167451,0.026468286386263404,0.3230359534969914
419183,Central California School of Continuing Education,3,383859,700,25000,409559,0.9372495782048496,0.0017091554574554582,0.06104126633769494
419235,Rivertown School of Beauty Barber Skin Care and Nails,3,627004,19820,13524,660348,0.9495054122977582,0.03001447721504419,0.02048011048719766
420246,Southwest College of Naturopathic Medicine & Health Sciences,2,7656801,74939,1590214,9321954,0.8213729653675613,0.008038979810456048,0.1705880548219826
423643,Midwestern University-Glendale,2,113417750,23320516,7608584,144346850,0.7857306896548141,0.16155888403522486,0.05271042630996104
426314,Embry-Riddle Aeronautical University-Worldwide,2,47877000,484000,11186000,59547000,0.8040203536702101,0.008128033318219222,0.1878516130115707
429085,American College of Acupuncture and Oriental Med,3,679539,61776,62734,804049,0.8451462535243499,0.0768311384007691,0.07802260807488101
429094,AOMA Graduate School of Integrative Medicine,3,1326298,27993,422454,1776745,0.7464762810645309,0.015755215295385663,0.23776850364008342
430670,San Juan Bautista School of Medicine,2,3753516,516906,719247,4989669,0.7522575144764112,0.10359524850245577,0.14414723702113308
433660,Florida Gulf Coast University,1,87841509,4810715,17631191,110283415,0.7965069725125941,0.04362138223594182,0.15987164525146416
434274,Academy of Hair Design-Lufkin,3,300300,3000,6250,309550,0.9701179130996608,0.009691487643353255,0.020190599256985946
434283,Academy of Hair Design-Beaumont,3,218700,2940,12123,233763,0.9355629419540303,0.012576840646295608,0.05186021739967403
434441,Florida College of Integrative Medicine,3,205904,35898,2777,244579,0.841871133662334,0.14677466176572804,0.011354204571937901
434751,White Earth Tribal and Community College,2,386900,33648,333820,754368,0.5128796555527276,0.04460422499363706,0.44251611945363534
435000,Louisiana State University Health Sciences Center-Shreveport,1,85722894,41797190,1919691,129439775,0.66226083906589,0.3229083950431774,0.014830765890932676
437097,University of Management and Technology,3,2266847,114170,393424,2774441,0.817046388804087,0.041150631784925326,0.14180297941098766
437608,Advanced Barber College and Hair Design,3,213970,9298,30341,253609,0.8437003418648392,0.036662736732529205,0.11963692140263162
440031,Keck Graduate Institute,2,13205772,3249028,3153793,19608593,0.6734686165396977,0.16569409136086408,0.16083729209943823
440138,Antioch University-System Administration,2,26640200,362255,4978379,31980834,0.8330051680328286,0.011327253066633597,0.15566757890053773
441104,Richmont Graduate University,2,1801581,27819,636540,2465940,0.7305859023333902,0.011281296381907103,0.2581328012847028
441900,Nevada State College,1,19486000,712000,5882000,26080000,0.7471625766871166,0.027300613496932514,0.22553680981595092
441937,California State University-Channel Islands,1,55900979,5252718,18744699,79898396,0.6996508290354164,0.06574247122558005,0.23460669973900353
441982,Franklin W Olin College of Engineering,2,11854000,3665000,11393000,26912000,0.44047265160523186,0.1361846016646849,0.4233427467300832
442806,Edward Via College of Osteopathic Medicine,2,43329259,9235277,7990481,60555017,0.7155354113764018,0.15251051783207328,0.131954070791525
443128,International Technological University,2,5444114,1032849,3088778,9565741,0.5691262182406988,0.10797375760016918,0.32290002415913205
443289,Toni & Guy Hairdressing Academy-Colorado Springs,3,200000,900,1000,201900,0.9905894006934126,0.004457652303120356,0.004952947003467063
443410,DigiPen Institute of Technology,3,12724585,14397,1809560,14548542,0.8746295676913879,9.895836984901993e-4,0.1243808486101219
443599,American College of Healthcare Sciences,3,994329,3978,1479452,2477759,0.4013017408069146,0.0016054830191314007,0.597092776173954
444361,Advanced Training Associates,3,536416,1150,89250,626816,0.8557790483969777,0.001834669185215438,0.14238628241780682
444635,Orion Institute,3,198632,39952,39888,278472,0.7132925392858169,0.14346864316699703,0.14323881754718606
444787,Nightingale College,3,3300236,77356,1981002,5358594,0.6158772245107579,0.014435876276500888,0.3696868992127412
445054,Toyota Technological Institute at Chicago,2,4339312,274825,1209729,5823866,0.7450913190653768,0.04718944426262555,0.2077192366719976
445188,University of California-Merced,1,85922237,45969882,38886494,170778613,0.5031205927407315,0.26917821378488416,0.22770119347438428
445735,Roseman University of Health Sciences,2,41035563,6386029,4020937,51442529,0.79769723218701,0.12413909510553028,0.07816367270745962
445780,Cosmetology School of Arts and Science LLC,3,187500,10000,10000,207500,0.9036144578313253,0.04819277108433735,0.04819277108433735
446002,American Academy of Acupuncture and Oriental Medicine,3,1012668,12679,71659,1097006,0.9231198370838446,0.011557821926224652,0.06532234098993077
446048,Ave Maria University,2,10937403,52999,11914079,22904481,0.47752241144429336,0.0023139140328043233,0.5201636745229024
447449,Academy of Hair Design-Jasper,3,153500,24275,25250,203025,0.75606452407339,0.1195665558428765,0.12436892008373353
447689,Georgia Gwinnett College,1,65640782,490370,12955284,79086436,0.8299878628997771,0.006200431133348834,0.16381170596687403
447801,University of East-West Medicine,3,39485,120000,158982,318467,0.12398458867009769,0.376805132085899,0.4992102792440033
447847,Aviator College of Aeronautical Science and Technology,3,4885473,35000,529516,5449989,0.8964188735059833,0.006422031310521911,0.09715909518349486
447953,SUM Bible College and Theological Seminary,2,1749600,366200,186600,2302400,0.7599027102154274,0.15905142460041696,0.08104586518415566
448840,University of South Florida-St Petersburg,1,28045216,8355584,11967393,48368193,0.5798276565758824,0.17274955878546053,0.24742278463865705
449339,American Public University System,3,61834000,942000,36828000,99604000,0.62079836151158585,0.009457451507971568,0.36974418698044254
449685,New Age Training,3,1144057,112110,509826,1765993,0.6478264636383043,0.06348269783628814,0.2886908385254075
449870,University of the West,2,2995997,51690,549174,3596861,0.8329476729848609,0.01437086392829748,0.15268146308684155
450304,Brite Divinity School,2,2928782,268591,380327,3577700,0.8186214607149845,0.0750736506694245,0.10630488861559102
451671,University of South Florida-Sarasota-Manatee,1,11131540,180419,2793286,14105245,0.7891773592021974,0.012790915719648967,0.19803172507815356
452106,Escuela De Troqueleria Y Herramentaje,1,231799,39134,67428,338361,0.6850641770180369,0.1156575373639397,0.19927828561802335
455406,Pacific Northwest University of Health Sciences,2,12953097,2816566,1969623,17739286,0.7301926920846757,0.1587756125021041,0.11103169541322012
455813,Pontifical John Paul II Institute for Studies on Marriage and Family,2,2188476,75892,13080,2277448,0.9609334658793527,0.033323263582747,0.005743270537900316
455983,Columbia College,3,343871,27594,597520,968985,0.3548775264838981,0.02847722100961315,0.6166452525064887
456542,Geisinger Commonwealth School of Medicine,2,16175053,2011191,2678068,20864312,0.7752497662036496,0.0963938326842505,0.12835640111209992
456959,University of Minnesota-Rochester,1,3076366,704049,2043606,5824021,0.5282202794255034,0.12088709844967935,0.3508926221248172
457192,Washington Barber College Inc,3,365221,29856,241150,636227,0.5740419692971219,0.04692664725011671,0.3790313834527614
457688,American Business and Technology University,3,897674,30000,1185043,2112717,0.4248907922831122,0.014199724809333195,0.5609094829075546
459736,Touro University California,2,24878117,2635729,5056890,32570736,0.7638180789037128,0.0809232250692769,0.15525869602701026
459949,Texas A&M University-San Antonio,1,38767109,442122,21666532,60875763,0.636823377474546,0.0072626933645168435,0.35591392916093717
461315,Keweenaw Bay Ojibwa Community College,1,395985,116473,516477,1028935,0.38484938310000144,0.11319762667223877,0.5019529902277597
461573,American Trade School,3,632363,13297,282711,928371,0.6811533320192036,0.014322937704861526,0.30452373027593493
461759,Simmons College of Kentucky,2,400589,50597,921812,1372998,0.291762260396592,0.03685147392785714,0.6713862656755508
461795,North American University,2,3932815,17959,1723301,5674075,0.6931200239686645,0.003165097394729537,0.30371487863660596
475015,Aveda Institute-Des Moines,3,792750,151709,210220,1154679,0.6865544450015979,0.13138629870292956,0.1820592562954726
475033,Relay Graduate School of Education,2,31115909,1590810,2732673,35439392,0.8780034657479451,0.04488818544065316,0.07710834881140173
475495,Rocky Mountain University of Health Professions,3,8103537,480615,1162721,9746873,0.8313986444678206,0.049309660647060854,0.11929169488511854
475565,Stella and Charles Guttman Community College,1,13015382,598477,6545890,20159749,0.6456123040023961,0.02968672873853737,0.32470096725906655
476595,Medical Allied Career Center,3,201915,45230,139128,386273,0.5227261548179656,0.11709335107553466,0.3601804941064998
476993,Medspa Academies,3,906000,172000,383000,1461000,0.6201232032854209,0.11772758384668036,0.2621492128678987
479992,Brand College,3,62000,9500,30000,101500,0.6108374384236454,0.09359605911330049,0.2955665024630542
480790,Rocky Vista University,3,18721464,163089,1978787,20863340,0.8973378183934116,0.007817012999836077,0.09484516860675232
480967,College of the Muscogee Nation,1,1243986,130946,615621,1990553,0.6249449273644058,0.06578372944603836,0.30927134318955585
481030,Future Generations University,2,1448607,227610,93357,1769574,0.8186190574680686,0.1286241773443778,0.052756765187553616
481058,Grace Mission University,2,184309,22500,50782,257591,0.7155102468642149,0.08734777224359547,0.19714198089218957
481128,Santa Ana Beauty College,3,90962,3489,31152,125603,0.7242024473937725,0.027777998933146503,0.24801955367308107
481340,The Salon Professional Academy-Nashville,3,350214,14670,170843,535727,0.6537172851097667,0.02738335010182425,0.318899364788409
481386,California Career Institute,3,1300000,10000,170000,1480000,0.8783783783783784,0.006756756756756757,0.11486486486486487
481483,Boca Beauty Academy,3,1056368,104188,105211,1265767,0.8345674993896981,0.08231214749634017,0.08312035311396174
482149,Augusta University,1,84179614,76897746,8487128,169564488,0.49644601291751606,0.4535014784463596,0.05005250863612433
482158,Middle Georgia State University,1,45405974,226738,9291794,54924506,0.826697904210554,0.004128175499657658,0.1691739202897883
482680,University of North Georgia,1,110372403,2060482,14832086,127264971,0.8672645908197315,0.016190488111610852,0.11654492106865762
482936,Florida Polytechnic University,1,9266435,4334845,4073824,17675104,0.524264807720509,0.24525145651193905,0.2304837357675519
482963,American Institute-Toms River,3,570259,35641,389252,995152,0.573037083782176,0.035814629322957696,0.3911482868948663
483036,Texas A & M University-Central Texas,1,13413753,1024217,6664703,21102673,0.6356423662537917,0.048534941521389256,0.3158226922248191
483276,JB's Hair Design and Barber College,3,110754,200,750,111704,0.9914953806488577,0.0017904461791878536,0.006714173171954451
483595,Universidad Ana G. Mendez-Online Campus,2,1096912,1782,1723297,2821991,0.3887014522725267,6.314690585476708e-4,0.6106670786689256
483975,Alabama College of Osteopathic Medicine,2,12567288,369338,2487148,15423774,0.8147998019161847,0.023946019955945932,0.16125417812786935
484905,University of North Texas at Dallas,1,20493982,39244,9501768,30034994,0.6823368101888084,0.0013066092172350692,0.3163565805939565
485494,Associated Barber College of San Diego,3,551435,2386,134235,688056,0.8014391270477984,0.003467740997825758,0.1950931319543758
485537,University of Texas Health Science Center at Tyler,1,18611945,15200721,88385,33901051,0.5490079053891279,0.4483849483014553,0.002607146309416779
486105,Professional Academy of Cosmetology,3,6000,1000,16500,23500,0.2553191489361702,0.0425531914893617,0.7021276595744681
486284,Bethany Global University,2,1453982,230399,489891,2174272,0.668721300738822,0.1059660428869985,0.2253126563741795
486327,Princess Beauty School,3,85950,3500,3400,92850,0.925686591276252,0.03769520732364028,0.0366182014001077
486433,Presidio Graduate School,2,2194046,140776,1773723,4108545,0.5340201944970786,0.03426419815287407,0.43171560735004727
486460,Wright Graduate University for the Realization of Human Potential,2,124030,11168,35829,171027,0.7252071310377893,0.06529963105240694,0.2094932379098037
486840,Kennesaw State University,1,169276021,2071660,48419176,219766857,0.7702527274164912,0.009426626144996923,0.22032064643851187
487010,The University of Tennessee Health Science Center,1,353912712,78110183,8001319,440024214,0.8043028104812432,0.17751337429807898,0.018183815220677833
487092,Emory University-Oxford College,2,12010000,38000,8660000,20708000,0.5799690940699247,0.001835039598222909,0.4181958663318524
487320,Texas State Technical College,1,80424380,364889,23139561,103928830,0.7738409063202193,0.0035109507150229632,0.2226481429647577
487852,American Institute of Alternative Medicine,3,28221,1145,6602,35968,0.7846141014234875,0.03183385231316726,0.1835520462633452
487904,Kentucky Horseshoeing School,3,276402,3000,8611,288013,0.9596858475138275,0.01041619649113061,0.02989795599504189
487977,Martinsburg College,3,935268,20000,1495859,2451127,0.3815665202170267,0.008159511930634357,0.6102739678523389
488138,Learning Bridge Career Institute,3,125000,2000,22000,149000,0.8389261744966443,0.013422818791946308,0.1476510067114094
488226,Center for Neurosomatic Studies,3,117723,75,31698,149496,0.7874658853748595,5.016856638304704e-4,0.21203242896131
488271,Fosbre Academy of Hair Design,3,324600,12400,52300,389300,0.8338042640637041,0.03185204212689442,0.13434369380940148
488396,Ultimate Touch Barber College,3,186816,1000,2000,189816,0.98419522063472,0.005268259788426687,0.010536519576853373
488527,Arkansas Colleges of Health Education,2,7885220,263790,1208966,9357976,0.8426202418129732,0.028188787831898692,0.12919097035512808
488554,Burrell College of Osteopathic Medicine,3,4808505,458689,1420351,6687545,0.7190239467547508,0.06858854781537918,0.21238750542987
488572,California Health Sciences University,3,5822274,63002,1075239,6960515,0.8364717265891963,0.009051341746982803,0.15447693166382084
488651,Glitz School of Cosmetology,3,201533,11489,12411,225433,0.8939818039062604,0.05096414455736294,0.055054051536376665
488907,Wongu University of Oriental Medicine,2,212416,28976,21,241413,0.8798863358642658,0.12002667627675394,8.698785898025376e-5
490133,Westcliff University,3,1274595,187440,712274,2174309,0.5862069282700849,0.08620669831196946,0.32758637341794566
490197,Regan Career Institute,3,50000,20000,15000,85000,0.5882352941176471,0.23529411764705882,0.17647058823529413
490249,Mobile Technical Training,3,306437,6622,45730,358789,0.8540869424647913,0.018456530161181085,0.12745652737402763
490373,Western Michigan University Homer Stryker M.D. School of Medicine,2,29914151,6867638,1365495,38147284,0.7841751197804803,0.1800295402419737,0.03579533997754598
490443,The Esthetic Institute,3,332084,58664,246659,637407,0.5209920819821559,0.0920353871231411,0.38697253089470307
490805,Purdue University Northwest,1,70944205,3669402,18181213,92794820,0.764527642814545,0.039543177086824456,0.1959291800986305
490869,American Institute-Somerset,3,425946,26622,295494,748062,0.5693993278631985,0.03558795928679708,0.3950127128500044
491871,Vogue International Academy,3,5800,500,1500,7800,0.7435897435897436,0.0641025641025641,0.19230769230769232
492689,Texas Tech University Health Sciences Center-El Paso,1,118152851,13043439,3280526,134476816,0.8786113065020814,0.09699396065415469,0.02439473284376394
493150,Gould's Academy,3,177386,61509,14009,252904,0.7013965773574162,0.24321086261980832,0.05539256002277544
